"","id2","totalPop17","age65_17","ageMed_17","totalPop12","percage65_12","ageMed_12","age65_12","totalChange","age65Change","percentChange","age65ChangeZ","percentChangeZ","age65_index"
"1","01001",55036,7843,37.8,54590,12.3,37,6715,446,1128,16.8,-0.16,0.28,0.104
"2","01003",203360,38687,42.6,183226,16.9,41.2,30965,20134,7722,24.94,0.79,0.94,0.88
"3","01005",26201,4571,39.7,27469,14.6,38.2,4010,-1268,561,13.99,-0.24,0.04,-0.072
"4","01007",22580,3402,39.8,22769,12.9,39.4,2937,-189,465,15.83,-0.26,0.2,0.016
"5","01009",57667,10008,40.9,57466,14.9,39.1,8562,201,1446,16.89,-0.12,0.28,0.12
"6","01011",10478,1590,40.8,10779,13.9,40.7,1498,-301,92,6.14,-0.31,-0.6,-0.484
"7","01013",20126,3731,40.7,20730,16.8,40.3,3483,-604,248,7.12,-0.29,-0.52,-0.428
"8","01015",115527,19005,39.1,117834,14.6,38.7,17204,-2307,1801,10.47,-0.06,-0.24,-0.168
"9","01017",33895,6300,43,34228,16.8,41.4,5750,-333,550,9.57,-0.25,-0.32,-0.292
"10","01019",25855,5422,46.1,25917,18.1,44.3,4691,-62,731,15.58,-0.22,0.18,0.02
"11","01021",43805,6790,38.9,43611,13.7,37.6,5975,194,815,13.64,-0.21,0.02,-0.072
"12","01023",13188,2836,45.8,13838,18.6,44,2574,-650,262,10.18,-0.29,-0.27,-0.278
"13","01025",24625,4544,42.2,25768,16.1,39.9,4149,-1143,395,9.52,-0.27,-0.32,-0.3
"14","01027",13407,2608,43.8,13828,17.8,41.7,2461,-421,147,5.97,-0.3,-0.61,-0.486
"15","01029",14939,2760,41.7,14905,16.2,41.2,2415,34,345,14.29,-0.28,0.07,-0.07
"16","01031",51073,8152,39.3,49966,14.6,37.8,7295,1107,857,11.75,-0.2,-0.14,-0.164
"17","01033",54435,10290,42.5,54451,17.4,41.7,9474,-16,816,8.61,-0.21,-0.4,-0.324
"18","01035",12649,2664,44.5,13188,18.3,43.3,2413,-539,251,10.4,-0.29,-0.25,-0.266
"19","01037",10955,2304,45.9,11305,17.1,44.4,1933,-350,371,19.19,-0.27,0.47,0.174
"20","01039",37519,7613,43.4,37803,18.8,42.5,7107,-284,506,7.12,-0.25,-0.52,-0.412
"21","01041",13866,2487,41.4,13971,15.9,40.3,2221,-105,266,11.98,-0.29,-0.12,-0.188
"22","01043",81703,14508,40.6,80403,16.1,40.1,12945,1300,1563,12.07,-0.1,-0.11,-0.106
"23","01045",49393,7798,37.1,50129,13.7,36,6868,-736,930,13.54,-0.19,0.01,-0.07
"24","01047",40755,6627,39.3,43572,14.1,37.3,6144,-2817,483,7.86,-0.26,-0.46,-0.38
"25","01049",71194,11415,39,70949,14,37.9,9933,245,1482,14.92,-0.11,0.12,0.028
"26","01051",80989,11420,38.5,79330,12,37.7,9520,1659,1900,19.96,-0.05,0.53,0.298
"27","01053",37621,6413,39.6,38122,15.1,38.7,5756,-501,657,11.41,-0.23,-0.17,-0.194
"28","01055",103132,18407,40.9,104317,15.9,40.2,16586,-1185,1821,10.98,-0.06,-0.2,-0.144
"29","01057",16657,3339,43.6,17219,18.2,43.1,3134,-562,205,6.54,-0.3,-0.57,-0.462
"30","01059",31507,5139,37.7,31664,14.9,38.3,4718,-157,421,8.92,-0.26,-0.37,-0.326
"31","01061",26572,5059,42.7,26769,17.6,42.2,4711,-197,348,7.39,-0.28,-0.5,-0.412
"32","01063",8533,1653,42,9067,16.1,41.4,1460,-534,193,13.22,-0.3,-0.02,-0.132
"33","01065",14995,2710,39.8,15750,15.2,40.4,2394,-755,316,13.2,-0.28,-0.02,-0.124
"34","01067",17110,3588,43.5,17275,18.1,42.9,3127,-165,461,14.74,-0.26,0.11,-0.038
"35","01069",104108,17203,39.6,101459,14.5,38.3,14712,2649,2491,16.93,0.04,0.29,0.19
"36","01071",52326,9808,43,53279,16.5,41.4,8791,-953,1017,11.57,-0.18,-0.15,-0.162
"37","01073",659460,96497,37.6,658464,13.2,37,86917,996,9580,11.02,1.06,-0.2,0.304
"38","01075",14021,2889,44.5,14513,18.8,42.6,2728,-492,161,5.9,-0.3,-0.62,-0.492
"39","01077",92590,17483,41.5,92528,16.9,40.4,15637,62,1846,11.81,-0.06,-0.13,-0.102
"40","01079",33288,5607,42,34148,14.4,41,4917,-860,690,14.03,-0.23,0.05,-0.062
"41","01081",156597,16836,31,140938,9.1,29.6,12825,15659,4011,31.27,0.26,1.46,0.98
"42","01083",91695,13135,39.1,83313,12.4,38.7,10331,8382,2804,27.14,0.08,1.12,0.704
"43","01085",10362,1801,40.7,11304,14.7,40.7,1662,-942,139,8.36,-0.31,-0.42,-0.376
"44","01087",19358,3440,38,21214,14.3,36.6,3034,-1856,406,13.38,-0.27,0,-0.108
"45","01089",353213,49381,38.2,334661,12.3,37.3,41163,18552,8218,19.96,0.86,0.53,0.662
"46","01091",19743,3688,42.1,20909,17,41.1,3555,-1166,133,3.74,-0.31,-0.79,-0.598
"47","01093",30058,6141,44.1,30641,18.7,43.2,5730,-583,411,7.17,-0.27,-0.51,-0.414
"48","01095",94738,15694,38.8,93070,14.9,38.1,13867,1668,1827,13.18,-0.06,-0.02,-0.036
"49","01097",414328,61878,37.3,412297,13,36.6,53599,2031,8279,15.45,0.87,0.16,0.444
"50","01099",21745,4048,41.7,22993,15.7,40,3610,-1248,438,12.13,-0.26,-0.11,-0.17
"51","01101",227120,31204,35.9,229376,12,34.7,27525,-2256,3679,13.37,0.21,-0.01,0.078
"52","01103",119157,19376,40.1,119330,14.2,38.7,16945,-173,2431,14.35,0.03,0.07,0.054
"53","01105",9680,1791,37.6,10525,16.8,37,1768,-845,23,1.3,-0.32,-0.99,-0.722
"54","01107",20170,3642,42.1,19646,17,41.4,3340,524,302,9.04,-0.28,-0.36,-0.328
"55","01109",33287,4744,31.4,32750,12.8,31.3,4192,537,552,13.17,-0.25,-0.02,-0.112
"56","01111",22530,4429,42.7,22843,17.5,40.7,3998,-313,431,10.78,-0.26,-0.22,-0.236
"57","01113",58480,7587,35.3,53938,12.6,35.6,6796,4542,791,11.64,-0.21,-0.15,-0.174
"58","01115",86937,13476,40.1,83530,13.3,38.8,11109,3407,2367,21.31,0.02,0.64,0.392
"59","01117",208721,28571,38.5,195237,10.8,36.9,21086,13484,7485,35.5,0.76,1.81,1.39
"60","01119",13084,2151,35.9,13669,15,37.1,2050,-585,101,4.93,-0.31,-0.7,-0.544
"61","01121",80888,13381,40.6,82194,14.2,39.4,11672,-1306,1709,14.64,-0.08,0.1,0.028
"62","01123",40756,8100,43.3,41534,17.5,41.8,7268,-778,832,11.45,-0.21,-0.16,-0.18
"63","01125",204424,24738,32.3,194254,10.9,31.4,21174,10170,3564,16.83,0.19,0.28,0.244
"64","01127",64927,11854,42.3,67016,16.4,41.5,10991,-2089,863,7.85,-0.2,-0.46,-0.356
"65","01129",16746,2893,43.5,17407,14.8,39.5,2576,-661,317,12.31,-0.28,-0.09,-0.166
"66","01131",10919,1945,40.5,11706,15.2,38.8,1779,-787,166,9.33,-0.3,-0.34,-0.324
"67","01133",23968,4938,44.6,24432,18,43.1,4398,-464,540,12.28,-0.25,-0.1,-0.16
"68","02013",3338,274,42.7,3114,3.8,40.7,118,224,156,132.2,-0.3,9.73,5.718
"69","02016",5784,319,37.7,5507,5.6,39.1,308,277,11,3.57,-0.32,-0.81,-0.614
"70","02020",298225,28148,33.1,291470,7.5,32.9,21860,6755,6288,28.76,0.58,1.26,0.988
"71","02050",17957,1267,26.9,17184,5.9,26.1,1014,773,253,24.95,-0.29,0.94,0.448
"72","02060",917,89,41.8,929,9.5,42.7,88,-12,1,1.14,-0.33,-1.01,-0.738
"73","02068",2303,174,38.4,1917,5.9,41.4,113,386,61,53.98,-0.32,3.32,1.864
"74","02070",4974,402,30.1,4887,7.5,28.6,367,87,35,9.54,-0.32,-0.32,-0.32
"75","02090",100031,8659,31,97523,6.5,30.7,6339,2508,2320,36.6,0.01,1.9,1.144
"76","02100",2537,570,45,2500,13.9,42.9,348,37,222,63.79,-0.29,4.13,2.362
"77","02105",2146,408,48.9,2153,15,48.3,323,-7,85,26.32,-0.31,1.06,0.512
"78","02110",32434,3679,38,31636,8.3,37.8,2626,798,1053,40.1,-0.17,2.18,1.24
"79","02122",57961,8577,40.6,55474,11.3,40.9,6269,2487,2308,36.82,0.01,1.92,1.156
"80","02130",13745,1861,39.5,13525,9.8,38.4,1325,220,536,40.45,-0.25,2.21,1.226
"81","02150",13773,1207,33.1,13710,6.9,31.5,946,63,261,27.59,-0.29,1.16,0.58
"82","02158",8129,439,24,,,,,,,,,,
"83","02164",1301,98,32.3,1551,6.8,28.7,105,-250,-7,-6.67,-0.33,-1.65,-1.122
"84","02170",101135,10218,34.9,89319,8,34.8,7146,11816,3072,42.99,0.12,2.42,1.5
"85","02180",9869,719,27.9,9580,6.3,28,604,289,115,19.04,-0.31,0.46,0.152
"86","02185",9757,595,34.6,9317,4.3,34.2,401,440,194,48.38,-0.3,2.86,1.596
"87","02188",7715,559,26.6,7601,6.2,25.7,471,114,88,18.68,-0.31,0.43,0.134
"88","02195",3275,548,41.7,3822,10.3,42.2,394,-547,154,39.09,-0.3,2.1,1.14
"89","02198",6473,895,41,5603,10,39,560,870,335,59.82,-0.28,3.8,2.168
"90","02220",8810,1225,38.9,8909,11,38.8,980,-99,245,25,-0.29,0.95,0.454
"91","02230",1038,117,42.9,1050,8.8,46.7,92,-12,25,27.17,-0.32,1.12,0.544
"92","02240",6889,840,36.6,7039,9.2,36.3,648,-150,192,29.63,-0.3,1.33,0.678
"93","02261",9439,1118,40,9614,8.4,39.6,808,-175,310,38.37,-0.28,2.04,1.112
"94","02275",2475,555,49.1,2368,20.4,50.8,483,107,72,14.91,-0.32,0.12,-0.056
"95","02282",682,95,39.4,644,8.7,39.1,56,38,39,69.64,-0.32,4.6,2.632
"96","02290",5453,685,34.7,5637,10.8,35.6,609,-184,76,12.48,-0.31,-0.08,-0.172
"97","04001",71602,9887,34.2,71618,11.8,32.1,8451,-16,1436,16.99,-0.12,0.29,0.126
"98","04003",126516,25825,40.5,131118,17.4,39.9,22815,-4602,3010,13.19,0.11,-0.02,0.032
"99","04005",138639,15433,30.6,134011,9.1,30.9,12195,4628,3238,26.55,0.14,1.07,0.698
"100","04007",53145,14355,49.3,53436,23.3,47.8,12451,-291,1904,15.29,-0.05,0.15,0.07
"101","04009",37700,4849,33.1,37115,11.6,31.8,4305,585,544,12.64,-0.25,-0.07,-0.142
"102","04011",9368,1106,33.4,8592,11.8,33.7,1014,776,92,9.07,-0.31,-0.36,-0.34
"103","04012",20477,7639,56,20460,33.2,54.1,6793,17,846,12.45,-0.2,-0.08,-0.128
"104","04013",4155501,586644,36,3841819,12.2,34.6,468702,313682,117942,25.16,16.75,0.96,7.276
"105","04015",204691,57356,50.4,201216,23.3,47.4,46883,3475,10473,22.34,1.19,0.73,0.914
"106","04017",107902,17550,35.9,107415,13.4,34.8,14394,487,3156,21.93,0.13,0.7,0.472
"107","04019",1007257,182720,38.2,981048,15.6,37.7,153043,26209,29677,19.39,3.97,0.49,1.882
"108","04021",405537,75576,38.5,368374,14.4,35.8,53046,37163,22530,42.47,2.94,2.38,2.604
"109","04023",46358,7572,36.6,47057,13.5,35.5,6353,-699,1219,19.19,-0.15,0.47,0.222
"110","04025",220972,63907,52.2,211280,24.3,49.3,51341,9692,12566,24.48,1.49,0.9,1.136
"111","04027",204281,35943,34.1,196420,16,33.6,31427,7861,4516,14.37,0.33,0.08,0.18
"112","05001",18352,3321,40.9,19029,16.6,41.5,3159,-677,162,5.13,-0.3,-0.68,-0.528
"113","05003",20771,3878,41.8,21811,16.3,39.5,3555,-1040,323,9.09,-0.28,-0.36,-0.328
"114","05005",41093,12528,51.8,41387,28.1,50.8,11630,-294,898,7.72,-0.2,-0.47,-0.362
"115","05007",251823,32666,35.2,222028,12.2,34.5,27087,29795,5579,20.6,0.48,0.59,0.546
"116","05009",37212,7350,42.2,37032,18.3,41.4,6777,180,573,8.46,-0.24,-0.41,-0.342
"117","05011",10994,2018,40.6,11510,17.3,40.2,1991,-516,27,1.36,-0.32,-0.99,-0.722
"118","05013",5194,1092,45.2,5373,17.8,42.4,956,-179,136,14.23,-0.31,0.06,-0.088
"119","05015",27782,5980,44.6,27321,18.9,44.2,5164,461,816,15.8,-0.21,0.19,0.03
"120","05017",11008,2117,43.3,11759,18.2,42.5,2140,-751,-23,-1.07,-0.33,-1.19,-0.846
"121","05019",22495,3507,33.8,23050,15,33.6,3458,-555,49,1.42,-0.32,-0.98,-0.716
"122","05021",15190,3172,43.4,15981,20.1,42.9,3212,-791,-40,-1.25,-0.33,-1.2,-0.852
"123","05023",25361,6596,48.9,25849,23.7,46.4,6126,-488,470,7.67,-0.26,-0.47,-0.386
"124","05025",8332,1626,42.6,8685,16,40.2,1390,-353,236,16.98,-0.29,0.29,0.058
"125","05027",23992,3976,36.2,24644,15.9,36.1,3918,-652,58,1.48,-0.32,-0.98,-0.716
"126","05029",20954,3875,41.2,21203,17.2,40.4,3647,-249,228,6.25,-0.29,-0.59,-0.47
"127","05031",104246,13679,34,96709,12,33.1,11605,7537,2074,17.87,-0.03,0.36,0.204
"128","05033",62119,9707,38.7,61670,13.5,38,8325,449,1382,16.6,-0.13,0.26,0.104
"129","05035",49278,6302,35,50618,10.9,33.8,5517,-1340,785,14.23,-0.21,0.06,-0.048
"130","05037",17164,3025,40.7,17891,15.5,39.4,2773,-727,252,9.09,-0.29,-0.36,-0.332
"131","05039",7585,1560,43.7,8122,18.3,42.9,1486,-537,74,4.98,-0.31,-0.69,-0.538
"132","05041",12094,2125,40.2,12922,15.6,39.1,2016,-828,109,5.41,-0.31,-0.66,-0.52
"133","05043",18620,3051,36.5,18615,14.7,37.5,2736,5,315,11.51,-0.28,-0.16,-0.208
"134","05045",121282,13976,32.3,113730,10.1,31.4,11487,7552,2489,21.67,0.03,0.67,0.414
"135","05047",17803,3336,41.4,18110,16.9,40.8,3061,-307,275,8.98,-0.29,-0.37,-0.338
"136","05049",12092,3026,48.1,12301,23.2,46.9,2854,-209,172,6.03,-0.3,-0.61,-0.486
"137","05051",97994,22167,44.7,96249,20.7,44.2,19924,1745,2243,11.26,0,-0.18,-0.108
"138","05053",18076,3076,39.9,17852,14.4,39.4,2571,224,505,19.64,-0.25,0.51,0.206
"139","05055",44197,6768,37.7,42224,14.2,37.8,5996,1973,772,12.88,-0.21,-0.05,-0.114
"140","05057",22154,3799,38.9,22548,15.1,38.6,3405,-394,394,11.57,-0.27,-0.15,-0.198
"141","05059",33480,6037,41.7,33011,15.7,39.6,5183,469,854,16.48,-0.2,0.25,0.07
"142","05061",13472,2295,38.5,13790,15.1,37.1,2082,-318,213,10.23,-0.29,-0.26,-0.272
"143","05063",37097,6275,39.8,36572,15.7,38,5742,525,533,9.28,-0.25,-0.34,-0.304
"144","05065",13521,3352,48,13614,23.5,47.3,3199,-93,153,4.78,-0.3,-0.71,-0.546
"145","05067",17429,2848,40.5,17885,15.9,40.9,2844,-456,4,0.14,-0.33,-1.09,-0.786
"146","05069",71373,11357,39,76836,13.4,37.2,10296,-5463,1061,10.3,-0.17,-0.26,-0.224
"147","05071",26155,4129,37.8,25554,14.9,37.6,3808,601,321,8.43,-0.28,-0.41,-0.358
"148","05073",7051,1569,45.8,7618,19.6,42.9,1493,-567,76,5.09,-0.31,-0.68,-0.532
"149","05075",16777,3238,42,17314,18.2,39.8,3151,-537,87,2.76,-0.31,-0.88,-0.652
"150","05077",9614,1710,41.9,10430,15.3,39.8,1596,-816,114,7.14,-0.31,-0.52,-0.436
"151","05079",13885,1979,38.6,14167,12.4,37.7,1757,-282,222,12.64,-0.29,-0.07,-0.158
"152","05081",12494,2487,42.5,13068,16.3,41.1,2130,-574,357,16.76,-0.27,0.27,0.054
"153","05083",21802,4103,42.2,22352,18,41.7,4023,-550,80,1.99,-0.31,-0.94,-0.688
"154","05085",71568,9068,35.8,68274,11.3,35.5,7715,3294,1353,17.54,-0.13,0.34,0.152
"155","05087",15907,2895,42.5,15674,15.3,40.4,2398,233,497,20.73,-0.25,0.6,0.26
"156","05089",16374,4423,51.8,16712,24.2,50.2,4044,-338,379,9.37,-0.27,-0.33,-0.306
"157","05091",43760,6879,38.5,43449,13.7,37.5,5953,311,926,15.56,-0.19,0.17,0.026
"158","05093",43534,6007,36.1,46388,12.3,34.6,5706,-2854,301,5.28,-0.28,-0.67,-0.514
"159","05095",7420,1634,46.1,8145,19.1,43.5,1556,-725,78,5.01,-0.31,-0.69,-0.538
"160","05097",9059,2335,50,9453,22.5,46.4,2127,-394,208,9.78,-0.3,-0.3,-0.3
"161","05099",8528,1661,43.8,9003,18.1,39.6,1630,-475,31,1.9,-0.32,-0.95,-0.698
"162","05101",7898,1887,48.8,8286,20.7,46.6,1715,-388,172,10.03,-0.3,-0.28,-0.288
"163","05103",24378,4531,42.8,25894,17.1,42.6,4428,-1516,103,2.33,-0.31,-0.91,-0.67
"164","05105",10320,1951,43.7,10413,17.3,42.1,1801,-93,150,8.33,-0.3,-0.42,-0.372
"165","05107",19518,3307,38.2,21646,15,37.3,3247,-2128,60,1.85,-0.32,-0.95,-0.698
"166","05109",10893,2102,41.8,11261,17.2,39.8,1937,-368,165,8.52,-0.3,-0.4,-0.36
"167","05111",24098,4148,39.7,24506,16.2,39.6,3970,-408,178,4.48,-0.3,-0.73,-0.558
"168","05113",20212,4372,43.8,20535,19.8,43.4,4066,-323,306,7.53,-0.28,-0.48,-0.4
"169","05115",63372,9342,34.9,61853,13.1,35.3,8103,1519,1239,15.29,-0.15,0.15,0.03
"170","05117",8309,1886,45.7,8659,19.8,44.6,1714,-350,172,10.04,-0.3,-0.28,-0.288
"171","05119",392848,54890,36.7,383185,12.1,36,46365,9663,8525,18.39,0.91,0.41,0.61
"172","05121",17514,3489,42.2,17992,18.6,41.3,3347,-478,142,4.24,-0.31,-0.75,-0.574
"173","05123",26688,3897,38.4,28089,12.2,36.9,3427,-1401,470,13.71,-0.26,0.02,-0.092
"174","05125",116252,19508,39,107498,15.3,38.7,16447,8754,3061,18.61,0.12,0.42,0.3
"175","05127",10584,2052,41.2,11170,17.9,41.4,1999,-586,53,2.65,-0.32,-0.88,-0.656
"176","05129",7925,1971,47.3,8146,21.6,47.1,1760,-221,211,11.99,-0.3,-0.12,-0.192
"177","05131",127362,18858,37.3,125795,13.1,36.6,16479,1567,2379,14.44,0.02,0.08,0.056
"178","05133",17206,2409,35,16978,12.5,33.9,2122,228,287,13.52,-0.28,0.01,-0.106
"179","05135",17041,4366,47.3,17278,23.8,46.4,4112,-237,254,6.18,-0.29,-0.59,-0.47
"180","05137",12443,3212,49.5,12480,22.5,46.9,2808,-37,404,14.39,-0.27,0.08,-0.06
"181","05139",40022,6714,39.7,41594,15.7,39.8,6530,-1572,184,2.82,-0.3,-0.87,-0.642
"182","05141",16751,4197,47.6,17223,22.9,46.5,3944,-472,253,6.41,-0.29,-0.58,-0.464
"183","05143",223683,24378,31.5,204057,9.8,31.1,19998,19626,4380,21.9,0.31,0.69,0.538
"184","05145",78706,12084,36.3,77007,14.2,36.1,10935,1699,1149,10.51,-0.16,-0.24,-0.208
"185","05147",6763,1463,45.3,7262,18.3,43.3,1329,-499,134,10.08,-0.31,-0.28,-0.292
"186","05149",21601,3573,39.7,22033,15.1,38.4,3327,-432,246,7.39,-0.29,-0.5,-0.416
"187","06001",1629615,208693,37.3,1515136,11.2,36.6,169695,114479,38998,22.98,5.32,0.78,2.596
"188","06003",1203,331,44.9,1197,12.3,43.2,147,6,184,125.17,-0.3,9.15,5.37
"189","06005",37306,9565,50.6,37764,20.8,48.4,7855,-458,1710,21.77,-0.08,0.68,0.376
"190","06007",225207,38949,36.9,220101,15.5,37.3,34116,5106,4833,14.17,0.37,0.06,0.184
"191","06009",45057,11585,51.6,45507,21.6,49.5,9830,-450,1755,17.85,-0.07,0.36,0.188
"192","06011",21479,2872,34.7,21329,11.9,33.9,2538,150,334,13.16,-0.28,-0.02,-0.124
"193","06013",1123678,163771,39.2,1052047,12.6,38.5,132558,71631,31213,23.55,4.19,0.83,2.174
"194","06015",27442,4357,38.7,28496,14.3,38.8,4075,-1054,282,6.92,-0.28,-0.53,-0.43
"195","06017",185015,34950,45.5,180441,14.8,43.5,26705,4574,8245,30.87,0.87,1.43,1.206
"196","06019",971616,110868,31.8,930517,10.1,30.7,93982,41099,16886,17.97,2.12,0.37,1.07
"197","06021",27935,4171,36.8,28078,13.2,36.5,3706,-143,465,12.55,-0.26,-0.07,-0.146
"198","06023",135490,21751,37.7,134317,13.3,37.5,17864,1173,3887,21.76,0.24,0.68,0.504
"199","06025",179957,21816,32.2,173487,10.6,31.8,18390,6470,3426,18.63,0.17,0.43,0.326
"200","06027",18195,3959,45.6,18474,19.1,45.7,3529,-279,430,12.18,-0.26,-0.1,-0.164
"201","06029",878744,89227,31.3,839153,9.1,30.7,76363,39591,12864,16.85,1.54,0.28,0.784
"202","06031",150183,14215,31.5,151982,8,31.2,12159,-1799,2056,16.91,-0.03,0.28,0.156
"203","06033",64095,13561,45.8,64360,17.7,44.8,11392,-265,2169,19.04,-0.01,0.46,0.272
"204","06035",31470,4001,36.2,34628,10.1,37.4,3497,-3158,504,14.41,-0.25,0.08,-0.052
"205","06037",10105722,1264984,36,9840024,11,34.8,1082403,265698,182581,16.87,26.11,0.28,10.612
"206","06039",154440,20191,33.7,150615,11.6,33.2,17471,3825,2720,15.57,0.07,0.17,0.13
"207","06041",260814,52965,46.1,252759,16.9,44.6,42716,8055,10249,23.99,1.16,0.86,0.98
"208","06043",17658,4598,51.1,18193,21.2,49.4,3857,-535,741,19.21,-0.22,0.47,0.194
"209","06045",87497,17221,42.4,87577,16,41.7,14012,-80,3209,22.9,0.14,0.77,0.518
"210","06047",267390,28611,30.8,256398,9.5,29.7,24358,10992,4253,17.46,0.29,0.33,0.314
"211","06049",9017,2214,47.8,9545,20.2,46.8,1928,-528,286,14.83,-0.28,0.11,-0.046
"212","06051",14058,1921,38.3,14181,9.6,37.1,1361,-123,560,41.15,-0.24,2.27,1.266
"213","06053",433168,53745,33.9,416199,10.8,32.9,44949,16969,8796,19.57,0.95,0.5,0.68
"214","06055",141005,24521,40.8,136644,15.3,39.6,20907,4361,3614,17.29,0.2,0.32,0.272
"215","06057",98838,24126,49.8,98521,19.7,48,19409,317,4717,24.3,0.36,0.89,0.678
"216","06059",3155816,426445,37.5,3021840,11.7,36.2,353555,133976,72890,20.62,10.23,0.59,4.446
"217","06061",374985,68244,41.6,350074,15.6,40.2,54612,24911,13632,24.96,1.65,0.94,1.224
"218","06063",18724,4824,52.1,19926,21.4,49.4,4264,-1202,560,13.13,-0.24,-0.03,-0.114
"219","06065",2355002,316979,35,2192982,11.9,33.7,260965,162020,56014,21.46,7.79,0.66,3.512
"220","06067",1495400,194729,35.9,1422348,11.3,34.9,160725,73052,34004,21.16,4.6,0.63,2.218
"221","06069",58671,6890,35.4,55467,10,34.1,5547,3204,1343,24.21,-0.13,0.88,0.476
"222","06071",2121220,225174,32.9,2041029,9,31.7,183693,80191,41481,22.58,5.68,0.75,2.722
"223","06073",3283665,425217,35.4,3100500,11.5,34.7,356558,183165,68659,19.26,9.62,0.48,4.136
"224","06075",864263,128384,38.3,807755,13.7,38.5,110662,56508,17722,16.01,2.24,0.21,1.022
"225","06077",724153,86538,33.9,687036,10.5,32.6,72139,37117,14399,19.96,1.76,0.53,1.022
"226","06079",280119,50662,39,270121,15.4,39.3,41599,9998,9063,21.79,0.99,0.68,0.804
"227","06081",763450,115064,39.6,721183,13.5,39.3,97360,42267,17704,18.18,2.24,0.39,1.13
"228","06083",442996,63210,33.7,423594,13,33.6,55067,19402,8143,14.79,0.85,0.11,0.406
"229","06085",1911226,239965,37,1788393,11.1,36.2,198512,122833,41453,20.88,5.68,0.61,2.638
"230","06087",273263,38885,37.3,262340,11.3,36.9,29644,10923,9241,31.17,1.01,1.45,1.274
"231","06089",178919,34728,41.8,177693,17.1,41.9,30386,1226,4342,14.29,0.3,0.07,0.162
"232","06091",2885,763,55,3163,21.8,51.6,690,-278,73,10.58,-0.32,-0.23,-0.266
"233","06093",43530,10180,47.9,44673,20,47,8935,-1143,1245,13.93,-0.15,0.04,-0.036
"234","06095",434981,61554,37.7,414209,11.5,37,47634,20772,13920,29.22,1.69,1.29,1.45
"235","06097",500943,87139,41.4,483456,14.1,39.8,68167,17487,18972,27.83,2.42,1.18,1.676
"236","06099",535684,65844,33.9,515115,10.8,32.8,55632,20569,10212,18.36,1.15,0.4,0.7
"237","06101",95583,13957,35.7,94615,12.8,34.5,12111,968,1846,15.24,-0.06,0.15,0.066
"238","06103",63247,11708,41.1,63200,16.1,39.6,10175,47,1533,15.07,-0.1,0.13,0.038
"239","06105",13037,3330,51.4,13693,20,49.2,2739,-656,591,21.58,-0.24,0.67,0.306
"240","06107",458809,48912,30.6,441877,9.5,29.7,41978,16932,6934,16.52,0.68,0.25,0.422
"241","06109",53899,12974,48.6,55205,20.7,48,11427,-1306,1547,13.54,-0.1,0.01,-0.034
"242","06111",847834,119246,37.5,822794,11.9,36.4,97912,25040,21334,21.79,2.76,0.68,1.512
"243","06113",212605,24477,30.9,200873,10,30.5,20087,11732,4390,21.85,0.31,0.69,0.538
"244","06115",74644,8687,32.4,72244,10.1,31.9,7297,2400,1390,19.05,-0.12,0.46,0.228
"245","08001",487850,46883,33.4,442996,8.5,32.4,37655,44854,9228,24.51,1.01,0.91,0.95
"246","08003",16345,2041,30.3,15750,11.4,32.2,1796,595,245,13.64,-0.29,0.02,-0.104
"247","08005",626612,75175,36.4,574357,10.3,35.7,59159,52255,16016,27.07,1.99,1.12,1.468
"248","08007",12592,2929,49.8,12109,17.2,47.5,2083,483,846,40.61,-0.2,2.23,1.258
"249","08009",3581,902,47.6,3783,24.6,47.8,931,-202,-29,-3.11,-0.33,-1.36,-0.948
"250","08011",5806,981,40.4,6192,14.1,40.6,873,-386,108,12.37,-0.31,-0.09,-0.178
"251","08013",316782,39969,36.2,297218,10.1,35.6,30019,19564,9950,33.15,1.12,1.61,1.414
"252","08014",64283,8007,37.8,55913,9.8,36.5,5479,8370,2528,46.14,0.04,2.68,1.624
"253","08015",18818,4528,49.9,17879,20.4,47.3,3647,939,881,24.16,-0.2,0.88,0.448
"254","08017",2127,272,35.8,2095,18.4,41,385,32,-113,-29.35,-0.34,-3.51,-2.242
"255","08019",9257,1653,47.2,9059,12.6,45.8,1141,198,512,44.87,-0.25,2.57,1.442
"256","08021",8147,1429,38.2,8241,15.7,38.2,1294,-94,135,10.43,-0.31,-0.25,-0.274
"257","08023",3628,954,51,3556,23.5,47.4,836,72,118,14.11,-0.31,0.05,-0.094
"258","08025",5514,736,38.2,5747,10.9,39.4,626,-233,110,17.57,-0.31,0.34,0.08
"259","08027",4505,1508,58.2,4208,20.7,52.7,871,297,637,73.13,-0.23,4.89,2.842
"260","08029",30217,7253,47.8,30710,21.1,46.1,6480,-493,773,11.93,-0.21,-0.12,-0.156
"261","08031",678467,75959,34.4,604356,10.4,33.7,62853,74111,13106,20.85,1.57,0.61,0.994
"262","08033",1736,424,49.4,1806,23.8,46.5,430,-70,-6,-1.4,-0.33,-1.22,-0.864
"263","08035",320940,33245,38.1,286883,7.3,36.7,20942,34057,12303,58.75,1.46,3.71,2.81
"264","08037",53726,5045,36.5,51850,5.7,34.2,2955,1876,2090,70.73,-0.02,4.69,2.806
"265","08039",24553,3486,45.6,23058,9.9,43,2283,1495,1203,52.69,-0.15,3.22,1.872
"266","08041",674826,79487,34,622816,10.1,34.1,62904,52010,16583,26.36,2.08,1.06,1.468
"267","08043",46601,9564,44.8,47006,17.7,43,8320,-405,1244,14.95,-0.15,0.12,0.012
"268","08045",57945,6584,36.2,56330,8.5,34.7,4788,1615,1796,37.51,-0.07,1.97,1.154
"269","08047",5793,869,45.2,5358,10.5,44.5,563,435,306,54.35,-0.28,3.35,1.898
"270","08049",14793,2325,44.1,14608,10.4,41.1,1519,185,806,53.06,-0.21,3.25,1.866
"271","08051",16215,1909,34.5,15385,8.9,34.3,1369,830,540,39.44,-0.25,2.13,1.178
"272","08053",820,219,57.2,790,30.5,56.5,241,30,-22,-9.13,-0.33,-1.85,-1.242
"273","08055",6498,1969,54.9,6730,25.2,51.5,1696,-232,273,16.1,-0.29,0.22,0.016
"274","08057",1372,292,49.2,1397,21,46.5,293,-25,-1,-0.34,-0.33,-1.13,-0.81
"275","08059",564029,85348,40.4,536095,12.7,40.2,68084,27934,17264,25.36,2.17,0.98,1.456
"276","08061",1368,292,41.1,1393,16.4,40.1,228,-25,64,28.07,-0.32,1.2,0.592
"277","08063",7846,1365,38.4,8210,16.3,39,1338,-364,27,2.02,-0.32,-0.94,-0.692
"278","08065",7481,839,39.3,7372,4.6,34.2,339,109,500,147.49,-0.25,10.98,6.488
"279","08067",54469,8148,39.7,51443,11.8,37.7,6070,3026,2078,34.23,-0.02,1.7,1.012
"280","08069",330976,46924,35.7,300870,12,35.4,36104,30106,10820,29.97,1.24,1.35,1.306
"281","08071",14151,3153,46,15385,18.1,44.2,2785,-1234,368,13.21,-0.27,-0.02,-0.12
"282","08073",5520,951,38.5,5443,16.8,39.4,914,77,37,4.05,-0.32,-0.77,-0.59
"283","08075",21885,3629,37.5,22541,14.4,37.5,3246,-656,383,11.8,-0.27,-0.13,-0.186
"284","08077",148798,25803,38.9,146562,15.1,37.9,22131,2236,3672,16.59,0.21,0.26,0.24
"285","08079",834,270,58.5,702,34.3,60.3,241,132,29,12.03,-0.32,-0.12,-0.2
"286","08081",13056,1723,37.7,13547,10.9,36.4,1477,-491,246,16.66,-0.29,0.26,0.04
"287","08083",25770,5171,44.1,25424,16.8,42.8,4271,346,900,21.07,-0.2,0.63,0.298
"288","08085",40908,8916,44.7,40994,18.1,42.6,7420,-86,1496,20.16,-0.11,0.55,0.286
"289","08087",28123,4261,36.6,28200,14.2,36,4004,-77,257,6.42,-0.29,-0.58,-0.464
"290","08089",18325,3536,40.2,18791,18.3,40.6,3439,-466,97,2.82,-0.31,-0.87,-0.646
"291","08091",4653,1230,53.7,4445,23.6,52.4,1049,208,181,17.25,-0.3,0.31,0.066
"292","08093",16900,3072,50.6,16168,12,47,1940,732,1132,58.35,-0.16,3.68,2.144
"293","08095",4327,753,38.5,4380,20.3,40.8,889,-53,-136,-15.3,-0.35,-2.35,-1.55
"294","08097",17747,2938,43.3,17000,12.4,43,2108,747,830,39.37,-0.21,2.12,1.188
"295","08099",12084,2024,37.4,12539,14.5,36.7,1818,-455,206,11.33,-0.3,-0.17,-0.222
"296","08101",163368,28356,38.8,159072,15.4,38.8,24497,4296,3859,15.75,0.23,0.19,0.206
"297","08103",6557,900,35.9,6728,12.5,36.8,841,-171,59,7.02,-0.32,-0.53,-0.446
"298","08105",11430,2094,40.7,11925,16.3,41.8,1944,-495,150,7.72,-0.3,-0.47,-0.402
"299","08107",24359,3180,39.9,23385,8.5,39.4,1988,974,1192,59.96,-0.15,3.81,2.226
"300","08109",6338,1254,48.8,6189,14.3,43.8,885,149,369,41.69,-0.27,2.31,1.278
"301","08111",569,97,46.9,747,14.7,37.9,110,-178,-13,-11.82,-0.33,-2.07,-1.374
"302","08113",7804,882,42,7432,7,38.2,520,372,362,69.62,-0.27,4.6,2.652
"303","08115",2357,589,48.4,2389,22.9,47.9,547,-32,42,7.68,-0.32,-0.47,-0.41
"304","08117",29722,3352,39.2,27753,8.3,36.3,2303,1969,1049,45.55,-0.17,2.63,1.51
"305","08119",23769,4553,49.8,23163,13.3,47.4,3081,606,1472,47.78,-0.11,2.81,1.642
"306","08121",4809,927,42.2,4796,19.5,44.2,935,13,-8,-0.86,-0.33,-1.17,-0.834
"307","08123",285729,32490,34.2,253552,9.7,33.2,24595,32177,7895,32.1,0.82,1.53,1.246
"308","08125",10109,1779,35.8,10032,16.1,36.3,1615,77,164,10.15,-0.3,-0.27,-0.282
"309","09001",947328,140926,40.2,918892,13.6,39.5,124969,28436,15957,12.77,1.99,-0.05,0.766
"310","09003",897417,145001,40.4,893504,14.6,39.9,130452,3913,14549,11.15,1.78,-0.19,0.598
"311","09005",184454,35388,46.9,189277,16.1,44.4,30474,-4823,4914,16.13,0.39,0.22,0.288
"312","09007",164110,30196,45.1,165639,15.6,43,25840,-1529,4356,16.86,0.31,0.28,0.292
"313","09009",862127,139534,40.1,860995,14.5,39.1,124844,1132,14690,11.77,1.8,-0.14,0.636
"314","09011",270772,45184,41,273723,14.3,40.3,39142,-2951,6042,15.44,0.55,0.16,0.316
"315","09013",151596,21751,37.9,152137,12.2,38.3,18561,-541,3190,17.19,0.14,0.31,0.242
"316","09015",116674,17777,41,118046,13,39.4,15346,-1372,2431,15.84,0.03,0.2,0.132
"317","10001",173145,27333,37.3,162785,13.7,36.6,22302,10360,5031,22.56,0.4,0.75,0.61
"318","10003",555036,78998,37.8,539665,12.4,37,66918,15371,12080,18.05,1.42,0.38,0.796
"319","10005",215551,54234,48.3,197681,21.1,45.4,41711,17870,12523,30.02,1.49,1.36,1.412
"320","11001",672391,79769,33.9,605759,11.4,33.9,69057,66632,10712,15.51,1.23,0.17,0.594
"321","12001",259865,33282,31.2,247973,10.8,30.1,26781,11892,6501,24.27,0.62,0.89,0.782
"322","12003",27537,3749,37.1,27010,10.8,35.9,2917,527,832,28.52,-0.21,1.24,0.66
"323","12005",180117,29281,39.6,168957,14.7,39.3,24837,11160,4444,17.89,0.32,0.36,0.344
"324","12007",26775,4669,40.9,28404,15.1,38.7,4289,-1629,380,8.86,-0.27,-0.38,-0.336
"325","12009",568183,129240,47.1,544019,20.6,45.5,112068,24164,17172,15.32,2.16,0.15,0.954
"326","12011",1890416,294961,40.1,1761993,14.3,39.7,251965,128423,42996,17.06,5.9,0.3,2.54
"327","12013",14458,2565,40.3,14639,15.8,40.1,2313,-181,252,10.89,-0.29,-0.21,-0.242
"328","12015",173236,66342,58.1,160380,34.5,55.9,55331,12856,11011,19.9,1.27,0.53,0.826
"329","12017",141373,50184,55.9,140805,32.1,54.2,45198,568,4986,11.03,0.4,-0.2,0.04
"330","12019",203291,29377,39.4,190891,11.9,38.2,22716,12400,6661,29.32,0.64,1.3,1.036
"331","12021",356774,107599,49.7,323548,26.7,47.1,86387,33226,21212,24.55,2.75,0.91,1.646
"332","12023",68484,12036,40.7,67546,15.5,40,10470,938,1566,14.96,-0.1,0.12,0.032
"333","12027",35675,7410,40.7,34628,18.1,38.5,6268,1047,1142,18.22,-0.16,0.39,0.17
"334","12029",16323,3665,47.6,16301,19.4,44.9,3162,22,503,15.91,-0.25,0.2,0.02
"335","12031",912043,118638,36,866431,11.2,35.7,97040,45612,21598,22.26,2.8,0.72,1.552
"336","12033",309924,49098,37,298864,14.5,37.5,43335,11060,5763,13.3,0.51,-0.01,0.198
"337","12035",105015,30184,50.3,95987,24.7,47.7,23709,9028,6475,27.31,0.61,1.14,0.928
"338","12037",11675,2416,44.3,11545,17.7,42.3,2043,130,373,18.26,-0.27,0.39,0.126
"339","12039",46113,7367,40.7,46823,13.5,38.9,6321,-710,1046,16.55,-0.17,0.25,0.082
"340","12041",17191,3447,42.8,16880,17.2,39.7,2903,311,544,18.74,-0.25,0.43,0.158
"341","12043",13197,3315,45.8,12952,22.1,43.4,2862,245,453,15.83,-0.26,0.2,0.016
"342","12045",16018,3056,44.3,15796,17.1,43.8,2701,222,355,13.14,-0.27,-0.02,-0.12
"343","12047",14238,2309,41.1,14728,13.3,38.4,1959,-490,350,17.87,-0.27,0.36,0.108
"344","12049",27326,4125,34.9,27347,13.4,33.1,3664,-21,461,12.58,-0.26,-0.07,-0.146
"345","12051",39064,5119,33.7,38669,11.8,32.6,4563,395,556,12.18,-0.25,-0.1,-0.16
"346","12053",179144,49222,48.9,172784,25.9,47.8,44751,6360,4471,9.99,0.32,-0.28,-0.04
"347","12055",100177,34526,53.1,98734,32.2,51.4,31792,1443,2734,8.6,0.07,-0.4,-0.212
"348","12057",1351087,182025,36.8,1238365,11.9,36.1,147365,112722,34660,23.52,4.69,0.83,2.374
"349","12059",19483,3748,42.2,19971,16.9,42.1,3375,-488,373,11.05,-0.27,-0.2,-0.228
"350","12061",147981,45596,52.2,138203,27.5,48.9,38006,9778,7590,19.97,0.77,0.53,0.626
"351","12063",48571,8805,41.5,49589,15.9,40.4,7885,-1018,920,11.67,-0.19,-0.15,-0.166
"352","12065",14085,2988,46,14564,16.8,43.6,2447,-479,541,22.11,-0.25,0.71,0.326
"353","12067",8684,1203,39.2,8668,12.7,33.8,1101,16,102,9.26,-0.31,-0.34,-0.328
"354","12069",326215,85286,46.6,297995,24.4,45.7,72711,28220,12575,17.29,1.5,0.32,0.792
"355","12071",700165,188866,47.8,624155,23.6,45.5,147301,76010,41565,28.22,5.69,1.21,3.002
"356","12073",285890,34002,30.5,276506,9.5,29.6,26268,9384,7734,29.44,0.79,1.31,1.102
"357","12075",39713,9322,46.4,40541,19.5,45.2,7905,-828,1417,17.93,-0.12,0.37,0.174
"358","12077",8347,1092,36.9,8300,10.5,38.2,872,47,220,25.23,-0.29,0.97,0.466
"359","12079",18518,3542,42.4,19187,16.2,40.2,3108,-669,434,13.96,-0.26,0.04,-0.08
"360","12081",363542,94636,47.6,324834,23.5,45.6,76336,38708,18300,23.97,2.32,0.86,1.444
"361","12083",343778,96367,48.5,331987,25.8,47.4,85653,11791,10714,12.51,1.23,-0.08,0.444
"362","12085",155719,46191,51.6,146497,27.5,49.8,40287,9222,5904,14.65,0.53,0.1,0.272
"363","12086",2702602,414322,39.5,2512219,14.2,38.2,356735,190383,57587,16.14,8.01,0.22,3.336
"364","12087",76745,15792,46.7,73475,17.4,46.4,12785,3270,3007,23.52,0.11,0.83,0.542
"365","12089",78435,15988,44.9,73303,16.5,43.1,12095,5132,3893,32.19,0.24,1.54,1.02
"366","12091",197591,29922,36.7,183400,13.8,37.7,25309,14191,4613,18.23,0.34,0.39,0.37
"367","12093",40228,7752,41,39779,16.9,39,6723,449,1029,15.31,-0.18,0.15,0.018
"368","12095",1290216,143768,34.7,1153795,9.7,33.7,111918,136421,31850,28.46,4.29,1.23,2.454
"369","12097",325168,40709,35.7,272355,11.2,35.4,30504,52813,10205,33.45,1.15,1.64,1.444
"370","12099",1426772,328507,44.4,1324085,21.7,43.5,287326,102687,41181,14.33,5.64,0.07,2.298
"371","12101",498136,111287,44.5,465276,20.9,43.8,97243,32860,14044,14.44,1.71,0.08,0.732
"372","12103",949842,222248,47.6,917389,21.4,46.3,196321,32453,25927,13.21,3.43,-0.02,1.36
"373","12105",652256,128991,40.4,604562,18.1,39.8,109426,47694,19565,17.88,2.51,0.36,1.22
"374","12107",72435,15701,44.8,74224,19.1,43.2,14177,-1789,1524,10.75,-0.1,-0.22,-0.172
"375","12109",226578,42223,43.1,191495,15.9,42.2,30448,35083,11775,38.67,1.38,2.07,1.794
"376","12111",298763,68140,44.6,278246,20.2,42.5,56206,20517,11934,21.23,1.4,0.64,0.944
"377","12113",166778,24779,39.5,153086,12.9,39.2,19748,13692,5031,25.48,0.4,0.99,0.754
"378","12115",404839,140720,55.1,380479,31.3,52.6,119090,24360,21630,18.16,2.81,0.39,1.358
"379","12117",449260,64875,39.1,423389,12.2,38.3,51653,25871,13222,25.6,1.59,1,1.236
"380","12119",116754,63263,66.4,94240,44.5,63,41937,22514,21326,50.85,2.76,3.06,2.94
"381","12121",43814,8715,41.7,42287,18.4,42.2,7781,1527,934,12,-0.19,-0.12,-0.148
"382","12123",22350,4126,41.4,22561,15.9,41.2,3587,-211,539,15.03,-0.25,0.13,-0.022
"383","12125",15300,2148,39.8,15400,10.2,39.8,1571,-100,577,36.73,-0.24,1.91,1.05
"384","12127",518660,121619,46.4,495581,21.3,45.3,105559,23079,16060,15.21,2,0.14,0.884
"385","12129",31586,4221,40.7,30449,10.9,39.5,3319,1137,902,27.18,-0.2,1.13,0.598
"386","12131",63457,11984,43.2,55349,16.4,43,9077,8108,2907,32.03,0.1,1.52,0.952
"387","12133",24472,4238,41.9,24732,15.6,40.8,3858,-260,380,9.85,-0.27,-0.29,-0.282
"388","13001",18471,2995,39.3,18279,13.4,38.8,2449,192,546,22.29,-0.25,0.73,0.338
"389","13003",8313,1038,34.9,8355,9.8,34.2,819,-42,219,26.74,-0.29,1.09,0.538
"390","13005",11279,1664,37.6,11124,13.1,35.7,1457,155,207,14.21,-0.3,0.06,-0.084
"391","13007",3251,619,43.6,3483,20.7,41.9,721,-232,-102,-14.15,-0.34,-2.26,-1.492
"392","13009",45527,6556,35.1,46378,12.2,34.2,5658,-851,898,15.87,-0.2,0.2,0.04
"393","13011",18363,3030,40.3,18250,12.8,38.2,2336,113,694,29.71,-0.23,1.33,0.706
"394","13013",75099,8632,35.1,69136,9.5,33.6,6568,5963,2064,31.43,-0.03,1.47,0.87
"395","13015",102623,13365,37.5,99872,10.8,36.7,10786,2751,2579,23.91,0.05,0.86,0.536
"396","13017",17272,2730,39,17612,14,38,2466,-340,264,10.71,-0.29,-0.22,-0.248
"397","13019",19014,3127,39.5,19131,14.2,37.9,2717,-117,410,15.09,-0.27,0.14,-0.024
"398","13021",153923,22156,36,155560,12.8,35.5,19912,-1637,2244,11.27,0,-0.18,-0.108
"399","13023",12779,2156,37.4,13009,15.3,38.7,1990,-230,166,8.34,-0.3,-0.42,-0.372
"400","13025",18411,2758,40.3,18279,12.6,37.9,2303,132,455,19.76,-0.26,0.52,0.208
"401","13027",15629,2960,43.2,16066,16.3,40.6,2619,-437,341,13.02,-0.28,-0.03,-0.13
"402","13029",34883,3508,34.8,30616,8.7,36.1,2664,4267,844,31.68,-0.2,1.49,0.814
"403","13031",73742,7826,28.1,70360,9.1,25.8,6403,3382,1423,22.22,-0.12,0.72,0.384
"404","13033",22645,3193,37.4,23242,12.1,35.5,2812,-597,381,13.55,-0.27,0.01,-0.102
"405","13035",23556,3461,38.4,23671,12.6,38.2,2983,-115,478,16.02,-0.26,0.21,0.022
"406","13037",6503,910,38.4,6581,11.7,38.8,770,-78,140,18.18,-0.31,0.39,0.11
"407","13039",52252,6114,31.6,50435,9.3,31.6,4690,1817,1424,30.36,-0.12,1.39,0.786
"408","13043",10894,1819,37.9,11007,15,37.6,1651,-113,168,10.18,-0.3,-0.27,-0.282
"409","13045",114898,14631,34.4,110750,11,33.6,12182,4148,2449,20.1,0.03,0.55,0.342
"410","13047",65870,10696,39.6,64226,13.9,38.7,8927,1644,1769,19.82,-0.07,0.52,0.284
"411","13049",12963,1848,41.4,12954,12.7,38,1645,9,203,12.34,-0.3,-0.09,-0.174
"412","13051",285506,39955,34.9,266344,12.5,34,33293,19162,6662,20.01,0.64,0.54,0.58
"413","13053",11096,409,23.7,11917,4.1,23.8,489,-821,-80,-16.36,-0.34,-2.44,-1.6
"414","13055",24880,4141,40.3,25905,14.8,39.5,3834,-1025,307,8.01,-0.28,-0.44,-0.376
"415","13057",235896,29121,38,215014,9.4,36.4,20211,20882,8910,44.08,0.96,2.51,1.89
"416","13059",123554,12221,27.3,117762,8.6,25.9,10128,5792,2093,20.67,-0.02,0.59,0.346
"417","13061",3024,656,44.6,3174,18.1,42.7,574,-150,82,14.29,-0.31,0.07,-0.082
"418","13063",274150,23074,32.4,262066,6.8,31.7,17820,12084,5254,29.48,0.44,1.31,0.962
"419","13065",6788,1033,37.6,6800,14.1,37.1,959,-12,74,7.72,-0.31,-0.47,-0.406
"420","13067",739072,81407,36.4,691820,8.9,35.4,61572,47252,19835,32.21,2.55,1.54,1.944
"421","13069",43048,5581,35.9,42566,11.3,34.8,4810,482,771,16.03,-0.21,0.21,0.042
"422","13071",45890,6530,36,45531,12.8,34.9,5828,359,702,12.05,-0.22,-0.11,-0.154
"423","13073",143723,17627,36.4,124665,10.4,36.9,12965,19058,4662,35.96,0.35,1.84,1.244
"424","13075",17190,2601,37,17073,13.4,36.5,2288,117,313,13.68,-0.28,0.02,-0.1
"425","13077",138015,17659,37.9,127212,10.4,36.7,13230,10803,4429,33.48,0.32,1.64,1.112
"426","13079",12385,2103,44.2,12701,13.4,40.8,1702,-316,401,23.56,-0.27,0.83,0.39
"427","13081",23005,3881,38.3,23460,14.3,37.7,3355,-455,526,15.68,-0.25,0.18,0.00799999999999999
"428","13083",16282,2885,41.8,16598,14.7,39.2,2440,-316,445,18.24,-0.26,0.39,0.13
"429","13085",23397,4466,43.3,22246,14.2,40.5,3159,1151,1307,41.37,-0.14,2.29,1.318
"430","13087",27023,4213,37.9,27815,14.1,37,3922,-792,291,7.42,-0.28,-0.49,-0.406
"431","13089",736066,81746,35.5,694671,9,34.3,62520,41395,19226,30.75,2.46,1.42,1.836
"432","13091",21063,3425,41.2,21509,13.9,39.5,2990,-446,435,14.55,-0.26,0.09,-0.05
"433","13093",14053,2459,43.5,14528,14,40.7,2034,-475,425,20.89,-0.26,0.61,0.262
"434","13095",91522,12970,35,94591,12.2,33.4,11540,-3069,1430,12.39,-0.12,-0.09,-0.102
"435","13097",140152,14947,36.3,132124,8.7,35,11495,8028,3452,30.03,0.17,1.36,0.884
"436","13099",10405,1921,40.5,10928,16.6,39,1814,-523,107,5.9,-0.31,-0.62,-0.496
"437","13101",4011,437,38.1,4024,10.7,32.4,431,-13,6,1.39,-0.32,-0.99,-0.722
"438","13103",57087,6268,36.2,52203,9.3,35.4,4855,4884,1413,29.1,-0.12,1.28,0.72
"439","13105",19288,3717,42.3,20103,16.8,41.2,3377,-815,340,10.07,-0.28,-0.28,-0.28
"440","13107",22502,3453,37.2,22600,14.1,36.9,3187,-98,266,8.35,-0.29,-0.42,-0.368
"441","13109",10757,1714,37.3,10935,13.6,35.9,1487,-178,227,15.27,-0.29,0.15,-0.026
"442","13111",24480,6606,50.8,23554,22,48.4,5182,926,1424,27.48,-0.12,1.15,0.642
"443","13113",110306,18237,43.5,106525,13,42.3,13848,3781,4389,31.69,0.31,1.5,1.024
"444","13115",96471,15318,38.3,96204,14.3,37.7,13757,267,1561,11.35,-0.1,-0.17,-0.142
"445","13117",211300,23423,38.2,177103,9.3,37,16471,34197,6952,42.21,0.68,2.36,1.688
"446","13119",22328,4249,41.1,22070,16.9,40,3730,258,519,13.91,-0.25,0.04,-0.076
"447","13121",1010420,108826,35.2,929535,9.1,34.2,84588,80885,24238,28.65,3.18,1.25,2.022
"448","13123",29614,6669,46,28232,18.2,42.9,5138,1382,1531,29.8,-0.1,1.34,0.764
"449","13125",3027,514,42.9,3082,15.8,39.4,487,-55,27,5.54,-0.32,-0.65,-0.518
"450","13127",83467,15150,40.8,79628,15.3,40,12183,3839,2967,24.35,0.1,0.89,0.574
"451","13129",56424,7664,37,55192,11.6,36,6402,1232,1262,19.71,-0.14,0.51,0.25
"452","13131",25048,4141,39.7,25068,14.1,38.2,3535,-20,606,17.14,-0.24,0.3,0.084
"453","13133",16732,4527,48.9,15988,21.4,46.4,3421,744,1106,32.33,-0.17,1.55,0.862
"454","13135",889954,78898,34.9,810624,7,33.8,56744,79330,22154,39.04,2.88,2.1,2.412
"455","13137",43878,7888,39.5,43038,15.4,38.6,6628,840,1260,19.01,-0.14,0.46,0.22
"456","13139",192865,26569,36,180831,11.4,34.5,20615,12034,5954,28.88,0.54,1.26,0.972
"457","13141",8667,1782,44.3,9422,15.8,42.1,1489,-755,293,19.68,-0.28,0.51,0.194
"458","13143",28722,4537,40.7,28627,13.9,39.2,3979,95,558,14.02,-0.24,0.05,-0.066
"459","13145",33198,5614,43.2,31870,13.5,42.3,4302,1328,1312,30.5,-0.14,1.4,0.784
"460","13147",25535,5249,43,25277,18.1,42.8,4575,258,674,14.73,-0.23,0.11,-0.026
"461","13149",11607,1848,41.9,11756,13.5,39.4,1587,-149,261,16.45,-0.29,0.25,0.034
"462","13151",217506,23102,36.7,203185,8.5,35.5,17271,14321,5831,33.76,0.52,1.66,1.204
"463","13153",150341,17819,35.1,140699,10.5,34.4,14773,9642,3046,20.62,0.12,0.59,0.402
"464","13155",9278,1687,39.7,9646,14.7,37.2,1418,-368,269,18.97,-0.29,0.45,0.154
"465","13157",63851,9117,38.7,60268,11.8,36.8,7112,3583,2005,28.19,-0.04,1.21,0.71
"466","13159",13732,2249,42.2,13786,12.6,37.7,1737,-54,512,29.48,-0.25,1.31,0.686
"467","13161",14999,2245,36.3,14972,12.7,35.7,1901,27,344,18.1,-0.28,0.38,0.116
"468","13163",15954,2695,38.6,16817,14.9,38.1,2506,-863,189,7.54,-0.3,-0.48,-0.408
"469","13165",8929,1397,40.6,8477,16.3,38.6,1382,452,15,1.09,-0.32,-1.01,-0.734
"470","13167",9800,1696,41.6,9981,14.1,40.2,1407,-181,289,20.54,-0.28,0.58,0.236
"471","13169",28540,4583,39.7,28638,12.9,39.1,3694,-98,889,24.07,-0.2,0.87,0.442
"472","13171",18282,2961,38.1,18151,13.9,38.2,2523,131,438,17.36,-0.26,0.32,0.088
"473","13173",10388,1311,33.8,10066,10.7,32.7,1077,322,234,21.73,-0.29,0.68,0.292
"474","13175",47451,7719,38.3,48264,14.5,38,6998,-813,721,10.3,-0.22,-0.26,-0.244
"475","13177",29216,3281,36.9,28449,8.7,35.9,2475,767,806,32.57,-0.21,1.57,0.858
"476","13179",62120,4939,27.9,64663,6.2,27.6,4009,-2543,930,23.2,-0.19,0.8,0.404
"477","13181",7768,1688,47.9,7962,18.1,45.2,1441,-194,247,17.14,-0.29,0.3,0.064
"478","13183",17857,1459,31.6,14488,8.3,30.2,1203,3369,256,21.28,-0.29,0.64,0.268
"479","13185",113941,12619,30.1,109730,9.8,29.8,10754,4211,1865,17.34,-0.06,0.32,0.168
"480","13187",31567,5129,37.3,30040,13.1,36.1,3935,1527,1194,30.34,-0.15,1.38,0.768
"481","13189",21488,3500,37.8,21762,13.8,38.5,3003,-274,497,16.55,-0.25,0.25,0.05
"482","13191",14061,3294,49.2,14119,17.7,43.5,2499,-58,795,31.81,-0.21,1.5,0.816
"483","13193",13675,2099,40.6,14552,12.7,38.9,1848,-877,251,13.58,-0.29,0.01,-0.11
"484","13195",28600,4580,41,27988,13.8,38.8,3862,612,718,18.59,-0.22,0.42,0.164
"485","13197",8558,1544,43.3,8615,14.3,41.2,1232,-57,312,25.32,-0.28,0.97,0.47
"486","13199",21152,4013,42,21966,16.2,41.6,3558,-814,455,12.79,-0.26,-0.05,-0.134
"487","13201",5884,1223,43.1,6094,18.6,41.2,1133,-210,90,7.94,-0.31,-0.45,-0.394
"488","13205",22574,3439,38.8,23510,13.2,37.2,3103,-936,336,10.83,-0.28,-0.21,-0.238
"489","13207",26795,4585,43.3,26376,14,40.7,3693,419,892,24.15,-0.2,0.88,0.448
"490","13209",8962,1399,39.4,9054,13.2,36.8,1195,-92,204,17.07,-0.3,0.3,0.06
"491","13211",18013,3317,44.2,17919,15.7,41.3,2813,94,504,17.92,-0.25,0.37,0.122
"492","13213",39444,5275,37.6,39635,10.8,36.5,4281,-191,994,23.22,-0.18,0.8,0.408
"493","13215",198647,24267,33.7,191278,11.6,33.4,22188,7369,2079,9.37,-0.02,-0.33,-0.206
"494","13217",105042,12618,36.2,100047,10,34.6,10005,4995,2613,26.12,0.05,1.04,0.644
"495","13219",35972,5091,40.1,32814,11.1,39.1,3642,3158,1449,39.79,-0.12,2.16,1.248
"496","13221",14654,2600,42.5,14745,14.5,41.4,2138,-91,462,21.61,-0.26,0.67,0.298
"497","13223",152399,14767,35.6,141846,7.5,34,10638,10553,4129,38.81,0.27,2.08,1.356
"498","13225",27027,3887,35.8,27531,11.4,33.9,3139,-504,748,23.83,-0.22,0.85,0.422
"499","13227",30343,6241,44.9,29445,16.8,41.7,4947,898,1294,26.16,-0.14,1.04,0.568
"500","13229",19141,3112,39.4,18631,13.9,38.6,2590,510,522,20.15,-0.25,0.55,0.23
"501","13231",17919,2687,40.5,17765,12.6,38.3,2238,154,449,20.06,-0.26,0.54,0.22
"502","13233",41444,6280,37.1,41350,13.6,36.9,5624,94,656,11.66,-0.23,-0.15,-0.182
"503","13235",11396,2124,43.1,11801,14.2,43.3,1676,-405,448,26.73,-0.26,1.09,0.55
"504","13237",21430,4726,45.6,21184,18.5,44.8,3919,246,807,20.59,-0.21,0.59,0.27
"505","13239",2140,688,52.6,2542,20.2,40.4,513,-402,175,34.11,-0.3,1.69,0.894
"506","13241",16354,4268,48.8,16297,21.3,45.4,3471,57,797,22.96,-0.21,0.78,0.384
"507","13243",7206,1662,44.3,7596,16.4,39.2,1246,-390,416,33.39,-0.27,1.63,0.87
"508","13245",201568,25830,33.7,200337,11.5,33.1,23039,1231,2791,12.11,0.08,-0.11,-0.034
"509","13247",88482,11487,37.3,85008,10.8,37.2,9181,3474,2306,25.12,0.01,0.96,0.58
"510","13249",5168,849,36.9,4963,11.9,37.7,591,205,258,43.65,-0.29,2.48,1.372
"511","13251",14037,2391,41.2,14574,15,39.7,2186,-537,205,9.38,-0.3,-0.33,-0.318
"512","13253",8549,1861,44,8815,19.1,43.7,1684,-266,177,10.51,-0.3,-0.24,-0.264
"513","13255",64192,10783,38.9,63979,13.4,37.1,8573,213,2210,25.78,-0.01,1.01,0.602
"514","13257",25625,4792,42.3,26003,17,40.5,4421,-378,371,8.39,-0.27,-0.41,-0.354
"515","13259",5832,888,37,5991,14.4,41.6,863,-159,25,2.9,-0.32,-0.86,-0.644
"516","13261",30687,4761,35.2,32425,12.8,34.2,4150,-1738,611,14.72,-0.24,0.1,-0.036
"517","13263",6423,1443,49.9,6772,16.6,45.3,1124,-349,319,28.38,-0.28,1.22,0.62
"518","13265",1844,392,43.3,1674,22.9,43.4,383,170,9,2.35,-0.32,-0.91,-0.674
"519","13267",25402,3351,36.9,25023,11.7,36.2,2928,379,423,14.45,-0.26,0.08,-0.056
"520","13269",8267,1511,43.8,8700,15.2,40.3,1322,-433,189,14.3,-0.3,0.07,-0.078
"521","13271",16339,2638,41,16312,13.8,39.2,2251,27,387,17.19,-0.27,0.31,0.078
"522","13273",8978,1588,40.7,9365,15.2,40.4,1423,-387,165,11.6,-0.3,-0.15,-0.21
"523","13275",44909,7500,39.6,44715,15.2,39.1,6797,194,703,10.34,-0.22,-0.25,-0.238
"524","13277",40531,5683,35.5,40430,13,34.4,5256,101,427,8.12,-0.26,-0.44,-0.368
"525","13279",27160,4169,36.1,27270,13.7,35.7,3736,-110,433,11.59,-0.26,-0.15,-0.194
"526","13281",11173,3756,53.3,10491,29.2,51.3,3063,682,693,22.62,-0.23,0.75,0.358
"527","13283",6752,1287,40.8,6851,15.3,37.8,1048,-99,239,22.81,-0.29,0.77,0.346
"528","13285",69433,9632,36.2,67146,12.5,36.1,8393,2287,1239,14.76,-0.15,0.11,0.00600000000000001
"529","13287",8036,1517,40.2,8834,15,39.5,1325,-798,192,14.49,-0.3,0.09,-0.066
"530","13289",8323,1710,46.3,8984,16.4,43.9,1473,-661,237,16.09,-0.29,0.22,0.016
"531","13291",22262,7031,53.8,21344,27.1,51,5784,918,1247,21.56,-0.15,0.67,0.342
"532","13293",26241,4652,41.5,27061,15.8,41,4276,-820,376,8.79,-0.27,-0.38,-0.336
"533","13295",68609,12104,41.4,68463,15.1,39.6,10338,146,1766,17.08,-0.07,0.3,0.152
"534","13297",88695,13005,38.9,83771,12,37.4,10053,4924,2952,29.36,0.1,1.3,0.82
"535","13299",35688,5879,38.9,36099,15.2,37.5,5487,-411,392,7.14,-0.27,-0.52,-0.42
"536","13301",5410,1107,44.2,5788,18.1,43.2,1048,-378,59,5.63,-0.32,-0.64,-0.512
"537","13303",20506,3317,40.3,21092,13.7,39.2,2890,-586,427,14.78,-0.26,0.11,-0.038
"538","13305",29833,4399,38.2,30157,13,37.6,3920,-324,479,12.22,-0.26,-0.1,-0.164
"539","13307",2627,501,43.5,2773,17.9,45.6,496,-146,5,1.01,-0.32,-1.02,-0.74
"540","13309",7952,1073,38.2,7572,10.4,36.6,787,380,286,36.34,-0.28,1.88,1.016
"541","13311",28509,5899,45.1,27141,17.8,43.2,4831,1368,1068,22.11,-0.17,0.71,0.358
"542","13313",103963,13601,35.4,102152,11.2,34,11441,1811,2160,18.88,-0.01,0.45,0.266
"543","13315",8896,1449,39.4,9142,14.5,39.7,1326,-246,123,9.28,-0.31,-0.34,-0.328
"544","13317",9905,2193,45.5,10398,19.2,44.2,1996,-493,197,9.87,-0.3,-0.29,-0.294
"545","13319",9147,1624,42.5,9577,16,40.5,1532,-430,92,6.01,-0.31,-0.61,-0.49
"546","13321",20809,3674,42.1,21746,14.5,39.4,3153,-937,521,16.52,-0.25,0.25,0.05
"547","15001",196325,36232,42.1,185399,14.8,40.6,27439,10926,8793,32.05,0.95,1.52,1.292
"548","15003",990060,162580,37.6,955215,14.6,37.7,139461,34845,23119,16.58,3.02,0.26,1.364
"549","15005",86,12,57.6,66,31.8,58.4,21,20,-9,-42.86,-0.33,-4.61,-2.898
"550","15007",71093,12829,42.1,67113,15.1,41.5,10134,3980,2695,26.59,0.06,1.08,0.672
"551","15009",164094,26473,40.9,154937,12.9,39.5,19987,9157,6486,32.45,0.61,1.56,1.18
"552","16001",435117,56491,36.4,394961,10.6,34.9,41866,40156,14625,34.93,1.79,1.76,1.772
"553","16003",3946,1070,52.8,3976,21.3,50.3,847,-30,223,26.33,-0.29,1.06,0.52
"554","16005",84113,10956,33.2,82584,11.2,31.5,9249,1529,1707,18.46,-0.08,0.41,0.214
"555","16007",5942,1188,39.3,5977,18.4,39.6,1100,-35,88,8,-0.31,-0.45,-0.394
"556","16009",9050,1970,46.5,9247,18,44.6,1664,-197,306,18.39,-0.28,0.41,0.134
"557","16011",45369,6007,33.3,45312,11.6,32,5256,57,751,14.29,-0.22,0.07,-0.046
"558","16013",21583,3557,42.8,21323,12.1,40.6,2580,260,977,37.87,-0.18,2,1.128
"559","16015",6968,1626,53.2,7014,16.1,48.8,1129,-46,497,44.02,-0.25,2.51,1.406
"560","16017",41855,9228,47.7,40806,17.6,45.7,7182,1049,2046,28.49,-0.03,1.23,0.726
"561","16019",110404,13672,32.6,104177,11,31.8,11459,6227,2213,19.31,-0.01,0.48,0.284
"562","16021",11323,2328,43.7,10857,17.1,42.6,1857,466,471,25.36,-0.26,0.98,0.484
"563","16023",2613,522,46.4,2828,21.7,45.9,614,-215,-92,-14.98,-0.34,-2.33,-1.534
"564","16025",886,184,47,1276,12.9,38,165,-390,19,11.52,-0.32,-0.16,-0.224
"565","16027",207027,26571,33.2,189396,11,31.6,20834,17631,5737,27.54,0.51,1.16,0.9
"566","16029",6862,1171,36.9,6872,16.1,38.1,1106,-10,65,5.88,-0.32,-0.62,-0.5
"567","16031",23472,3099,31.8,22813,12.6,32.1,2874,659,225,7.83,-0.29,-0.46,-0.392
"568","16033",1055,113,29.7,780,15.3,37.3,119,275,-6,-5.04,-0.33,-1.51,-1.038
"569","16035",8533,2193,50.3,8679,22.4,49.5,1944,-146,249,12.81,-0.29,-0.05,-0.146
"570","16037",4141,1217,53.4,4338,17.6,47.9,763,-197,454,59.5,-0.26,3.77,2.158
"571","16039",26232,3244,31.4,26655,10.2,30.3,2719,-423,525,19.31,-0.25,0.48,0.188
"572","16041",13120,1758,32.6,12739,12.7,32,1618,381,140,8.65,-0.31,-0.39,-0.358
"573","16043",12889,2104,36.7,13123,14.2,33.8,1863,-234,241,12.94,-0.29,-0.04,-0.14
"574","16045",16850,3510,45.2,16768,18.9,42.2,3169,82,341,10.76,-0.28,-0.22,-0.244
"575","16047",15110,2523,37.3,15327,15.6,35,2391,-217,132,5.52,-0.31,-0.65,-0.514
"576","16049",16275,4106,49.5,16215,21.4,48.3,3470,60,636,18.33,-0.23,0.4,0.148
"577","16051",27410,2921,31.3,25940,9.8,30.2,2542,1470,379,14.91,-0.27,0.12,-0.036
"578","16053",23039,2884,32.6,22140,11.1,31.4,2458,899,426,17.33,-0.26,0.32,0.088
"579","16055",150128,26135,39.7,139083,14.7,39.1,20445,11045,5690,27.83,0.5,1.18,0.908
"580","16057",38697,4633,28.3,37365,10.3,28.1,3849,1332,784,20.37,-0.21,0.57,0.258
"581","16059",7755,2138,52.9,7892,23.2,50,1831,-137,307,16.77,-0.28,0.27,0.05
"582","16061",3824,917,48.1,3818,22.3,47.7,851,6,66,7.76,-0.32,-0.47,-0.41
"583","16063",5296,667,33.1,5167,10.8,33.1,558,129,109,19.53,-0.31,0.5,0.176
"584","16065",38241,2405,23.5,37311,5.7,22.7,2127,930,278,13.07,-0.29,-0.03,-0.134
"585","16067",20448,3187,35.4,19909,14.6,35.4,2907,539,280,9.63,-0.29,-0.31,-0.302
"586","16069",40014,7651,41.3,39226,17.9,41,7021,788,630,8.97,-0.23,-0.37,-0.314
"587","16071",4284,811,39.5,4236,17.5,39.7,741,48,70,9.45,-0.32,-0.33,-0.326
"588","16073",11384,1922,38.6,11479,13.9,35.8,1596,-95,326,20.43,-0.28,0.57,0.23
"589","16075",22839,3859,38.8,22614,15.5,38,3505,225,354,10.1,-0.27,-0.27,-0.27
"590","16077",7667,1148,34.8,7717,12.1,34,934,-50,214,22.91,-0.29,0.78,0.352
"591","16079",12490,2733,47.2,12797,19.8,46.5,2534,-307,199,7.85,-0.3,-0.46,-0.396
"592","16081",10776,1018,36.4,10007,6.7,33.9,670,769,348,51.94,-0.28,3.15,1.778
"593","16083",82248,12165,34.6,77122,14,34.6,10797,5126,1368,12.67,-0.13,-0.06,-0.088
"594","16085",10104,2481,50.2,9793,16.8,46.7,1645,311,836,50.82,-0.2,3.06,1.756
"595","16087",9996,2366,46.1,10144,19.8,44,2009,-148,357,17.77,-0.27,0.35,0.102
"596","17001",66787,12782,41.5,67098,17.7,40.4,11876,-311,906,7.63,-0.19,-0.48,-0.364
"597","17003",6776,1350,42.3,8147,17.2,41,1401,-1371,-51,-3.64,-0.33,-1.4,-0.972
"598","17005",17034,2895,40.4,17762,15.9,40.4,2824,-728,71,2.51,-0.32,-0.9,-0.668
"599","17007",53638,7679,38.3,54141,11.7,36.6,6334,-503,1345,21.23,-0.13,0.64,0.332
"600","17009",6791,930,38.7,6913,12.4,37.2,857,-122,73,8.52,-0.32,-0.4,-0.368
"601","17011",33619,6879,43.7,34798,18.3,42.6,6368,-1179,511,8.02,-0.25,-0.44,-0.364
"602","17013",4897,1106,46.5,5065,20.4,44.6,1033,-168,73,7.07,-0.32,-0.52,-0.44
"603","17015",14704,3494,47.4,15338,21.4,46.5,3282,-634,212,6.46,-0.29,-0.57,-0.458
"604","17017",12880,2116,40.2,13570,15.4,37.9,2090,-690,26,1.24,-0.32,-1,-0.728
"605","17019",207946,24026,29.7,200931,10.1,28.9,20294,7015,3732,18.39,0.21,0.41,0.33
"606","17021",33562,6290,42.7,34805,17.7,41.6,6160,-1243,130,2.11,-0.31,-0.93,-0.682
"607","17023",15924,2970,43,16353,18,42.8,2944,-429,26,0.88,-0.32,-1.03,-0.746
"608","17025",13393,2622,44,13828,18,42.5,2489,-435,133,5.34,-0.31,-0.66,-0.52
"609","17027",37640,5950,40.4,37793,15,39.4,5669,-153,281,4.96,-0.28,-0.69,-0.526
"610","17029",52540,8163,34.3,53683,14.2,32.3,7623,-1143,540,7.08,-0.25,-0.52,-0.412
"611","17031",5238541,708546,36.4,5197677,12,35.3,623721,40864,84825,13.6,11.96,0.01,4.79
"612","17033",19214,3524,42.5,19777,17.4,42,3441,-563,83,2.41,-0.31,-0.9,-0.664
"613","17035",10899,2016,41.9,11044,16.7,40.6,1844,-145,172,9.33,-0.3,-0.34,-0.324
"614","17037",104473,12032,30.7,104820,9.8,29.4,10272,-347,1760,17.13,-0.07,0.3,0.152
"615","17039",16176,2927,42.8,16562,17.1,42,2832,-386,95,3.35,-0.31,-0.83,-0.622
"616","17041",19830,3339,37.9,19908,15.7,38.3,3126,-78,213,6.81,-0.29,-0.54,-0.44
"617","17043",931826,130303,39.1,918608,11.7,38.2,107477,13218,22826,21.24,2.98,0.64,1.576
"618","17045",17603,3614,44.5,18513,18.8,43,3480,-910,134,3.85,-0.31,-0.79,-0.598
"619","17047",6570,1309,43.6,6691,18.2,43.1,1218,-121,91,7.47,-0.31,-0.49,-0.418
"620","17049",34164,5652,39.1,34258,15.4,39.5,5276,-94,376,7.13,-0.27,-0.52,-0.42
"621","17051",21980,3899,41.4,22082,16.2,39.7,3577,-102,322,9,-0.28,-0.36,-0.328
"622","17053",13470,2525,43.2,14045,19,42.5,2669,-575,-144,-5.4,-0.35,-1.54,-1.064
"623","17055",39302,7692,42.3,39518,18.5,41.8,7311,-216,381,5.21,-0.27,-0.67,-0.51
"624","17057",35733,6872,42.5,36989,18,42.3,6658,-1256,214,3.21,-0.29,-0.84,-0.62
"625","17059",5226,1196,44.8,5592,21,45,1174,-366,22,1.87,-0.32,-0.95,-0.698
"626","17061",13311,2456,42.7,13828,17.5,41.3,2420,-517,36,1.49,-0.32,-0.98,-0.716
"627","17063",50333,6572,37.5,49870,11.2,36.4,5585,463,987,17.67,-0.18,0.35,0.138
"628","17065",8259,1721,43.6,8430,19.9,43.3,1678,-171,43,2.56,-0.32,-0.89,-0.662
"629","17067",18264,4009,46,19063,20,44.7,3813,-799,196,5.14,-0.3,-0.68,-0.528
"630","17069",4161,856,46.8,4315,21.4,45.9,923,-154,-67,-7.26,-0.34,-1.7,-1.156
"631","17071",6927,1678,49.2,7275,21.3,47.6,1550,-348,128,8.26,-0.31,-0.42,-0.376
"632","17073",49649,9557,42.7,50378,17.1,41.9,8615,-729,942,10.93,-0.19,-0.21,-0.202
"633","17075",28457,5830,44.3,29689,19.2,43.2,5700,-1232,130,2.28,-0.31,-0.91,-0.67
"634","17077",59115,8100,31.1,59992,11.6,29.1,6959,-877,1141,16.4,-0.16,0.24,0.08
"635","17079",9608,1770,43,9707,17.1,42.7,1660,-99,110,6.63,-0.31,-0.56,-0.46
"636","17081",38358,6845,40.9,38908,16.3,40.5,6342,-550,503,7.93,-0.25,-0.45,-0.37
"637","17083",22215,3988,42.5,22939,15.8,41.3,3624,-724,364,10.04,-0.27,-0.28,-0.276
"638","17085",22046,5644,49.4,22663,21.5,47.2,4873,-617,771,15.82,-0.21,0.19,0.03
"639","17087",12899,2508,42.5,12653,17.1,42,2164,246,344,15.9,-0.28,0.2,0.00799999999999998
"640","17089",529402,64242,36.6,514891,9.8,34.7,50459,14511,13783,27.32,1.67,1.14,1.352
"641","17091",110801,17148,37.7,113170,13.4,36.7,15165,-2369,1983,13.08,-0.04,-0.03,-0.034
"642","17093",122933,11422,34.5,114226,7.1,33,8110,8707,3312,40.84,0.15,2.24,1.404
"643","17095",51374,10233,42.2,52698,18.6,41.8,9802,-1324,431,4.4,-0.26,-0.74,-0.548
"644","17097",704476,89865,38,701282,10.5,36.7,73635,3194,16230,22.04,2.02,0.7,1.228
"645","17099",111151,19652,41.8,113688,16.5,41.1,18759,-2537,893,4.76,-0.2,-0.71,-0.506
"646","17101",16457,2789,41.2,16778,16,40.8,2684,-321,105,3.91,-0.31,-0.78,-0.592
"647","17103",34670,6243,42.7,35778,15.9,41.6,5689,-1108,554,9.74,-0.25,-0.3,-0.28
"648","17105",36812,6487,41.6,38903,15.8,40.2,6147,-2091,340,5.53,-0.28,-0.65,-0.502
"649","17107",29488,5065,40.6,30278,15.8,39.4,4784,-790,281,5.87,-0.28,-0.62,-0.484
"650","17109",31597,5064,31.3,32568,14.2,29.4,4625,-971,439,9.49,-0.26,-0.32,-0.296
"651","17111",308043,39824,39.9,308163,10.3,38,31741,-120,8083,25.47,0.84,0.99,0.93
"652","17113",173231,20468,32.7,169689,10.4,32.2,17648,3542,2820,15.98,0.08,0.21,0.158
"653","17115",107587,19745,41,110558,16.5,40.4,18242,-2971,1503,8.24,-0.11,-0.43,-0.302
"654","17117",45960,8640,43.1,47712,17.1,41.9,8159,-1752,481,5.9,-0.26,-0.62,-0.476
"655","17119",266153,42741,40,268586,14.4,38.4,38676,-2433,4065,10.51,0.26,-0.24,-0.04
"656","17121",38305,7228,41.8,39319,17.4,41.4,6842,-1014,386,5.64,-0.27,-0.64,-0.492
"657","17123",11925,2649,46.3,12567,20,44.9,2513,-642,136,5.41,-0.31,-0.66,-0.52
"658","17125",13904,3010,45.5,14636,19.2,44.3,2810,-732,200,7.12,-0.3,-0.52,-0.432
"659","17127",14594,2979,43.8,15370,18.4,42.3,2828,-776,151,5.34,-0.3,-0.66,-0.516
"660","17129",12416,2284,42.3,12728,15.9,43,2024,-312,260,12.85,-0.29,-0.05,-0.146
"661","17131",15794,3246,44.8,16421,18.3,43.7,3005,-627,241,8.02,-0.29,-0.44,-0.38
"662","17133",33739,5496,42.3,33003,14.3,40.5,4719,736,777,16.47,-0.21,0.25,0.066
"663","17135",29173,5518,42.4,29977,17.4,41.8,5216,-804,302,5.79,-0.28,-0.63,-0.49
"664","17137",34442,6496,41.2,35544,16.8,40.9,5971,-1102,525,8.79,-0.25,-0.38,-0.328
"665","17139",14711,2685,39.9,14844,18,41,2672,-133,13,0.49,-0.32,-1.06,-0.764
"666","17141",51619,8970,41.9,53378,15.4,40.9,8220,-1759,750,9.12,-0.22,-0.35,-0.298
"667","17143",186145,28945,37,186399,14,36.7,26096,-254,2849,10.92,0.09,-0.21,-0.09
"668","17145",21467,3768,41.8,22287,15.9,39.7,3544,-820,224,6.32,-0.29,-0.58,-0.464
"669","17147",16433,3022,43,16679,16.6,42.8,2769,-246,253,9.14,-0.29,-0.35,-0.326
"670","17149",15930,3177,42.4,16436,19,42,3123,-506,54,1.73,-0.32,-0.96,-0.704
"671","17151",4360,1218,52.2,4399,20.8,47.9,915,-39,303,33.11,-0.28,1.61,0.854
"672","17153",5691,1179,43.3,6107,18.1,43.5,1105,-416,74,6.7,-0.31,-0.55,-0.454
"673","17155",5771,1238,47.5,5968,17.8,44.6,1062,-197,176,16.57,-0.3,0.26,0.036
"674","17157",32829,5752,41.5,33353,16.1,41.2,5370,-524,382,7.11,-0.27,-0.52,-0.42
"675","17159",15953,3145,42.3,16181,19.5,43.6,3155,-228,-10,-0.32,-0.33,-1.13,-0.81
"676","17161",146205,26174,40,147504,16.3,40.1,24043,-1299,2131,8.86,-0.02,-0.38,-0.236
"677","17163",264433,37862,38,268873,12.7,37.1,34147,-4440,3715,10.88,0.21,-0.21,-0.042
"678","17165",24430,4701,42,24975,18.5,41.8,4620,-545,81,1.75,-0.31,-0.96,-0.7
"679","17167",198134,31929,40.1,197474,13.9,39.3,27449,660,4480,16.32,0.32,0.24,0.272
"680","17169",7181,1477,46.6,7499,18.3,43.2,1372,-318,105,7.65,-0.31,-0.47,-0.406
"681","17171",5109,984,43.7,5322,17.9,43.1,953,-213,31,3.25,-0.32,-0.83,-0.626
"682","17173",21906,4593,44.6,22316,19.3,44,4307,-410,286,6.64,-0.28,-0.56,-0.448
"683","17175",5551,1171,45,5983,20.5,44,1227,-432,-56,-4.56,-0.33,-1.47,-1.014
"684","17177",45839,9549,44.7,47532,19,43.7,9031,-1693,518,5.74,-0.25,-0.63,-0.478
"685","17179",134695,23273,40.8,135201,15.7,39.9,21227,-506,2046,9.64,-0.03,-0.31,-0.198
"686","17181",17267,3360,43.5,17799,18.3,43.3,3257,-532,103,3.16,-0.31,-0.84,-0.628
"687","17183",79207,14271,40.2,81463,16.2,39.6,13197,-2256,1074,8.14,-0.17,-0.43,-0.326
"688","17185",11568,2238,42.8,11935,18,42.8,2148,-367,90,4.19,-0.31,-0.76,-0.58
"689","17187",17429,3150,39.1,17723,16.7,40,2960,-294,190,6.42,-0.3,-0.58,-0.468
"690","17189",14260,2707,43,14692,17.3,42.4,2542,-432,165,6.49,-0.3,-0.57,-0.462
"691","17191",16569,3435,43.4,16727,19.7,42.6,3295,-158,140,4.25,-0.31,-0.75,-0.574
"692","17193",14186,3004,43.8,14686,20.8,44.5,3055,-500,-51,-1.67,-0.33,-1.24,-0.876
"693","17195",56823,11009,42.9,58400,17.6,42,10278,-1577,731,7.11,-0.22,-0.52,-0.4
"694","17197",687727,80436,37.3,677669,9.4,35.5,63701,10058,16735,26.27,2.1,1.05,1.47
"695","17199",67477,11931,40.9,66335,16.5,40.4,10945,1142,986,9.01,-0.18,-0.36,-0.288
"696","17201",287512,46416,39.6,294433,13.9,38.4,40926,-6921,5490,13.41,0.47,0,0.188
"697","17203",38942,6397,39.9,38736,14.8,40.1,5733,206,664,11.58,-0.23,-0.15,-0.182
"698","18001",35018,5175,33.3,34343,13.9,34.3,4774,675,401,8.4,-0.27,-0.41,-0.354
"699","18003",367747,49629,35.7,355940,12,35.4,42713,11807,6916,16.19,0.68,0.23,0.41
"700","18005",81024,12438,38.1,77297,14,38.1,10822,3727,1616,14.93,-0.09,0.12,0.036
"701","18007",8685,1478,40.9,8816,15.9,39.8,1402,-131,76,5.42,-0.31,-0.66,-0.52
"702","18009",12214,2460,43.7,12742,18.1,42,2306,-528,154,6.68,-0.3,-0.55,-0.45
"703","18011",63013,7911,38.4,56823,11.9,38.5,6762,6190,1149,16.99,-0.16,0.29,0.11
"704","18013",15007,3447,49.3,15181,17.7,47.3,2687,-174,760,28.28,-0.22,1.22,0.644
"705","18015",19994,3659,42.3,20105,16.2,41.3,3257,-111,402,12.34,-0.27,-0.09,-0.162
"706","18017",38248,6438,40.5,38875,15,38.6,5831,-627,607,10.41,-0.24,-0.25,-0.246
"707","18019",114893,16698,38.8,110100,12.9,38.1,14203,4793,2495,17.57,0.04,0.34,0.22
"708","18021",26375,4441,40.9,26908,15.3,40.7,4117,-533,324,7.87,-0.28,-0.46,-0.388
"709","18023",32455,5092,38.2,33179,14.4,37.8,4778,-724,314,6.57,-0.28,-0.56,-0.448
"710","18025",10598,1935,43.7,10702,15,41.3,1605,-104,330,20.56,-0.28,0.58,0.236
"711","18027",32777,4854,34.6,31604,14.1,35.7,4456,1173,398,8.93,-0.27,-0.37,-0.33
"712","18029",49564,7884,42.7,49904,13.2,40.2,6587,-340,1297,19.69,-0.14,0.51,0.25
"713","18031",26480,4179,38.8,25772,14.6,38.8,3763,708,416,11.06,-0.27,-0.2,-0.228
"714","18033",42524,6421,39.1,42218,13.1,37.9,5531,306,890,16.09,-0.2,0.22,0.052
"715","18035",115938,18843,35.4,117459,14.7,34.6,17266,-1521,1577,9.13,-0.1,-0.35,-0.25
"716","18037",42379,6835,40.2,41995,14.8,40.6,6215,384,620,9.98,-0.24,-0.28,-0.264
"717","18039",202924,27668,35.4,198214,12.1,34.8,23984,4710,3684,15.36,0.21,0.16,0.18
"718","18041",23426,4414,42.4,24220,16.6,40.7,4021,-794,393,9.77,-0.27,-0.3,-0.288
"719","18043",76481,11346,39.9,74601,12.9,39.2,9624,1880,1722,17.89,-0.08,0.36,0.184
"720","18045",16620,3200,43,17212,17.6,42,3029,-592,171,5.65,-0.3,-0.64,-0.504
"721","18047",22835,3778,42.3,23108,14.4,39.9,3328,-273,450,13.52,-0.26,0.01,-0.098
"722","18049",20296,3694,41.9,20762,16.2,40.3,3363,-466,331,9.84,-0.28,-0.3,-0.292
"723","18051",33596,5520,40.5,33437,15.4,40.2,5149,159,371,7.21,-0.27,-0.51,-0.414
"724","18053",67615,12141,39.9,69886,16.3,39.8,11391,-2271,750,6.58,-0.22,-0.56,-0.424
"725","18055",32431,6003,42.8,33032,16.2,41.5,5351,-601,652,12.18,-0.23,-0.1,-0.152
"726","18057",309687,33917,36.6,276098,8.8,35.7,24297,33589,9620,39.59,1.07,2.14,1.712
"727","18059",72776,11064,40.2,69778,12.9,39,9001,2998,2063,22.92,-0.03,0.78,0.456
"728","18061",39450,6551,42.7,39102,13.9,40.7,5435,348,1116,20.53,-0.16,0.58,0.284
"729","18063",158170,20015,37.6,145880,10.9,36.8,15901,12290,4114,25.87,0.27,1.02,0.72
"730","18065",48649,8767,42.2,49381,16.4,41.8,8098,-732,669,8.26,-0.23,-0.42,-0.344
"731","18067",82457,14975,41.5,82914,16.4,40.7,13598,-457,1377,10.13,-0.13,-0.27,-0.214
"732","18069",36520,5915,40.3,37144,14.7,39.3,5460,-624,455,8.33,-0.26,-0.42,-0.356
"733","18071",43779,6784,38.2,42414,14.5,38.5,6150,1365,634,10.31,-0.23,-0.26,-0.248
"734","18073",33448,5442,39,33369,14.2,38.3,4738,79,704,14.86,-0.22,0.12,-0.016
"735","18075",21107,3614,39.8,21353,15.5,39.1,3310,-246,304,9.18,-0.28,-0.35,-0.322
"736","18077",32293,5230,40.6,32501,14.7,40.5,4778,-208,452,9.46,-0.26,-0.33,-0.302
"737","18079",27840,4229,39.6,28373,12.7,37.9,3603,-533,626,17.37,-0.24,0.32,0.096
"738","18081",149359,20712,37.3,140033,12.4,37.1,17364,9326,3348,19.28,0.16,0.48,0.352
"739","18083",37763,6369,38.1,38392,15.9,38.9,6104,-629,265,4.34,-0.29,-0.75,-0.566
"740","18085",78720,12065,38,77328,13.5,37.8,10439,1392,1626,15.58,-0.09,0.18,0.072
"741","18087",38720,5018,31.5,37284,11.6,30.7,4325,1436,693,16.02,-0.23,0.21,0.034
"742","18089",488694,74262,38.6,495230,13.4,37.3,66361,-6536,7901,11.91,0.82,-0.13,0.25
"743","18091",110839,18081,40.2,111335,14.3,39.5,15921,-496,2160,13.57,-0.01,0.01,0.002
"744","18093",45669,8541,42.6,46131,16.6,41.4,7658,-462,883,11.53,-0.2,-0.16,-0.176
"745","18095",129641,22367,40.2,131244,15.5,39.3,20343,-1603,2024,9.95,-0.03,-0.29,-0.186
"746","18097",939964,110147,34.3,904535,10.7,33.9,96785,35429,13362,13.81,1.61,0.03,0.662
"747","18099",46752,7722,39.8,47045,14.6,38.2,6869,-293,853,12.42,-0.2,-0.08,-0.128
"748","18101",10219,1819,42,10300,15.9,42,1638,-81,181,11.05,-0.3,-0.2,-0.24
"749","18103",36035,5973,39.9,36850,14.1,39.9,5196,-815,777,14.95,-0.21,0.12,-0.012
"750","18105",144436,17055,28.8,138048,10.2,27.8,14081,6388,2974,21.12,0.11,0.63,0.422
"751","18107",38288,6534,40.5,38207,15.6,39.5,5960,81,574,9.63,-0.24,-0.31,-0.282
"752","18109",69533,10721,41.5,69033,13.1,39.9,9043,500,1678,18.56,-0.08,0.42,0.22
"753","18111",14056,2470,42.5,14199,16.5,42.8,2343,-143,127,5.42,-0.31,-0.66,-0.52
"754","18113",47421,6833,38.5,47547,12.7,37.1,6038,-126,795,13.17,-0.21,-0.02,-0.096
"755","18115",5911,1187,46.8,6093,17,43.9,1036,-182,151,14.58,-0.3,0.09,-0.066
"756","18117",19623,3576,41.3,19828,15.8,39.8,3133,-205,443,14.14,-0.26,0.06,-0.068
"757","18119",20957,3766,44.6,21583,15,42.7,3237,-626,529,16.34,-0.25,0.24,0.044
"758","18121",17062,3040,42.2,17251,15.7,41.1,2708,-189,332,12.26,-0.28,-0.1,-0.172
"759","18123",19229,3337,41.9,19408,15.4,41.3,2989,-179,348,11.64,-0.28,-0.15,-0.202
"760","18125",12471,2398,43.9,12849,17.1,42.8,2197,-378,201,9.15,-0.3,-0.35,-0.33
"761","18127",167391,24949,39.4,164386,12.6,38.5,20713,3005,4236,20.45,0.29,0.57,0.458
"762","18129",25599,4372,42.5,25840,14.4,41.6,3721,-241,651,17.5,-0.23,0.33,0.106
"763","18131",12761,2316,41.8,13395,16.8,41.6,2250,-634,66,2.93,-0.32,-0.86,-0.644
"764","18133",37543,5803,37.8,37995,13.6,38,5167,-452,636,12.31,-0.23,-0.09,-0.146
"765","18135",25203,4762,42.1,26101,17.1,41.2,4463,-898,299,6.7,-0.28,-0.55,-0.442
"766","18137",28372,4749,40.6,28702,15,39.2,4305,-330,444,10.31,-0.26,-0.26,-0.26
"767","18139",16765,2951,41.6,17349,16.1,40.3,2793,-584,158,5.66,-0.3,-0.64,-0.504
"768","18141",268613,39579,36.5,266785,13.4,36.1,35749,1828,3830,10.71,0.23,-0.22,-0.04
"769","18143",23722,3771,40.7,24044,13.6,39.1,3270,-322,501,15.32,-0.25,0.15,-0.01
"770","18145",44339,7026,41.3,44435,14,39.9,6221,-96,805,12.94,-0.21,-0.04,-0.108
"771","18147",20610,3730,43.2,20948,15.6,42.3,3268,-338,462,14.14,-0.26,0.06,-0.068
"772","18149",22966,3884,41.7,23310,15.8,40.5,3683,-344,201,5.46,-0.3,-0.65,-0.51
"773","18151",34459,6268,42.7,34116,15,40,5117,343,1151,22.49,-0.16,0.74,0.38
"774","18153",20900,3485,41.4,21379,14.9,39.4,3185,-479,300,9.42,-0.28,-0.33,-0.31
"775","18155",10617,1836,40,10509,14.5,40.6,1524,108,312,20.47,-0.28,0.58,0.236
"776","18157",186081,19806,28.1,173317,9.5,27.7,16465,12764,3341,20.29,0.16,0.56,0.4
"777","18159",15290,2955,44.5,15917,17.7,43,2817,-627,138,4.9,-0.31,-0.7,-0.544
"778","18161",7225,1299,43.3,7449,15,40.2,1117,-224,182,16.29,-0.3,0.23,0.018
"779","18163",181831,28459,37.9,179610,14.5,37.5,26043,2221,2416,9.28,0.02,-0.34,-0.196
"780","18165",15644,2936,43.2,16224,16.9,41.5,2742,-580,194,7.08,-0.3,-0.52,-0.432
"781","18167",107723,16231,36.1,107805,13.5,36.2,14554,-82,1677,11.52,-0.08,-0.16,-0.128
"782","18169",31848,6202,42,32804,18.3,41.6,6003,-956,199,3.32,-0.3,-0.83,-0.618
"783","18171",8269,1597,44.6,8490,16.8,42.6,1426,-221,171,11.99,-0.3,-0.12,-0.192
"784","18173",61581,9905,40.5,59643,13.6,39.5,8111,1938,1794,22.12,-0.07,0.71,0.398
"785","18175",27807,4443,41.2,28162,13.7,39,3858,-355,585,15.16,-0.24,0.14,-0.012
"786","18177",66972,12163,41.1,68797,16.5,40.5,11352,-1825,811,7.14,-0.21,-0.52,-0.396
"787","18179",27832,4825,39.8,27677,16,40.3,4428,155,397,8.97,-0.27,-0.37,-0.33
"788","18181",24279,4580,42,24612,17.2,42.2,4233,-333,347,8.2,-0.28,-0.43,-0.37
"789","18183",33481,5609,41,33234,14.1,40,4686,247,923,19.7,-0.19,0.51,0.23
"790","19001",7192,1578,45.7,7628,21.8,45.4,1663,-436,-85,-5.11,-0.34,-1.52,-1.048
"791","19003",3785,844,47.7,4027,22.2,46.5,894,-242,-50,-5.59,-0.33,-1.56,-1.068
"792","19005",13940,2984,45,14285,19.6,44.2,2800,-345,184,6.57,-0.3,-0.56,-0.456
"793","19007",12547,2778,45.1,12858,20.4,44.2,2623,-311,155,5.91,-0.3,-0.62,-0.492
"794","19009",5711,1374,48.3,6077,23.4,46.7,1422,-366,-48,-3.38,-0.33,-1.38,-0.96
"795","19011",25646,4403,42.1,26044,15.5,40.4,4037,-398,366,9.07,-0.27,-0.36,-0.324
"796","19013",132960,20128,34.9,130843,13.9,34.6,18187,2117,1941,10.67,-0.04,-0.23,-0.154
"797","19015",26381,4455,41.4,26324,16,40.9,4212,57,243,5.77,-0.29,-0.63,-0.494
"798","19017",24741,4681,39.2,24294,17.2,38.3,4179,447,502,12.01,-0.25,-0.12,-0.172
"799","19019",21101,3605,38.7,20988,15.4,38.9,3232,113,373,11.54,-0.27,-0.16,-0.204
"800","19021",20369,2890,35.1,20215,15.3,36.5,3093,154,-203,-6.56,-0.36,-1.64,-1.128
"801","19023",14822,3178,43.7,14899,20,43.6,2980,-77,198,6.64,-0.3,-0.56,-0.456
"802","19025",9814,2201,45.1,9936,23,47.5,2285,-122,-84,-3.68,-0.34,-1.4,-0.976
"803","19027",20428,3906,41.7,20751,18.7,42.5,3880,-323,26,0.67,-0.32,-1.05,-0.758
"804","19029",13327,2915,44.6,13865,21,44.8,2912,-538,3,0.1,-0.33,-1.09,-0.786
"805","19031",18368,3397,41.9,18446,17.1,42.8,3154,-78,243,7.7,-0.29,-0.47,-0.398
"806","19033",43134,8689,44.5,44083,18.1,43.4,7979,-949,710,8.9,-0.22,-0.37,-0.31
"807","19035",11577,2631,46.3,12011,21.8,47.3,2618,-434,13,0.5,-0.32,-1.06,-0.764
"808","19037",12140,2372,44.2,12409,19.1,43.9,2370,-269,2,0.08,-0.33,-1.09,-0.786
"809","19039",9267,1591,40.7,9286,17.4,41.5,1616,-19,-25,-1.55,-0.33,-1.23,-0.87
"810","19041",16387,3270,42.2,16649,18.7,42.8,3113,-262,157,5.04,-0.3,-0.69,-0.534
"811","19043",17711,3829,46.5,18056,19.4,44.7,3503,-345,326,9.31,-0.28,-0.34,-0.316
"812","19045",47587,8872,42.2,49074,16.8,41.6,8244,-1487,628,7.62,-0.23,-0.48,-0.38
"813","19047",17131,2873,37.6,17100,16.6,38,2839,31,34,1.2,-0.32,-1,-0.728
"814","19049",80864,9104,35.1,66997,9.9,34.3,6633,13867,2471,37.25,0.03,1.95,1.182
"815","19051",8834,1542,37.5,8718,17.2,38.6,1499,116,43,2.87,-0.32,-0.87,-0.65
"816","19053",8105,1494,36.5,8382,18,38.4,1509,-277,-15,-0.99,-0.33,-1.18,-0.84
"817","19055",17326,3154,43.4,17721,16.8,41.9,2977,-395,177,5.95,-0.3,-0.61,-0.486
"818","19057",39876,7632,42.5,40268,17.7,41.8,7127,-392,505,7.09,-0.25,-0.52,-0.412
"819","19059",17000,4126,48.7,16778,22.8,48.3,3825,222,301,7.87,-0.28,-0.46,-0.388
"820","19061",96571,15897,38.6,93776,15.2,38.7,14254,2795,1643,11.53,-0.09,-0.16,-0.132
"821","19063",9661,1892,42.5,10263,18.8,40.2,1929,-602,-37,-1.92,-0.33,-1.26,-0.888
"822","19065",20139,4199,43.7,20894,19.4,42.3,4053,-755,146,3.6,-0.3,-0.81,-0.606
"823","19067",15904,3399,44.6,16204,20,43.6,3241,-300,158,4.88,-0.3,-0.7,-0.54
"824","19069",10326,2085,42.4,10650,19.2,43,2045,-324,40,1.96,-0.32,-0.94,-0.692
"825","19071",6985,1500,46,7373,19.6,45.4,1445,-388,55,3.81,-0.32,-0.79,-0.602
"826","19073",9046,1930,45.7,9304,21,45.1,1954,-258,-24,-1.23,-0.33,-1.2,-0.852
"827","19075",12354,2472,42.4,12431,19,42.5,2362,-77,110,4.66,-0.31,-0.72,-0.556
"828","19077",10664,2309,45.7,10915,19.8,44.9,2161,-251,148,6.85,-0.3,-0.54,-0.444
"829","19079",15201,2956,42.6,15614,18.6,42.1,2904,-413,52,1.79,-0.32,-0.95,-0.698
"830","19081",10971,2305,44.5,11320,19,44.7,2151,-349,154,7.16,-0.3,-0.51,-0.426
"831","19083",17239,3608,44.4,17479,21,43.6,3671,-240,-63,-1.72,-0.33,-1.24,-0.876
"832","19085",14196,2670,44,14838,17.9,42.7,2656,-642,14,0.53,-0.32,-1.06,-0.764
"833","19087",19865,3515,40.4,20242,15.7,39.8,3178,-377,337,10.6,-0.28,-0.23,-0.25
"834","19089",9321,1871,41.8,9568,19.3,42.4,1847,-247,24,1.3,-0.32,-0.99,-0.722
"835","19091",9586,1950,43,9818,20.7,44.4,2032,-232,-82,-4.04,-0.34,-1.43,-0.994
"836","19093",6965,1512,44.7,7113,20.8,44.8,1480,-148,32,2.16,-0.32,-0.92,-0.68
"837","19095",16231,2891,41.8,16320,17.3,42.3,2823,-89,68,2.41,-0.32,-0.9,-0.668
"838","19097",19409,3847,44.6,19807,18.7,43.9,3704,-398,143,3.86,-0.3,-0.78,-0.588
"839","19099",36789,6786,42.6,36823,16.6,41.7,6113,-34,673,11.01,-0.23,-0.2,-0.212
"840","19101",17945,3425,40.9,16791,15.3,44,2569,1154,856,33.32,-0.2,1.63,0.898
"841","19103",144425,14933,29.9,131627,8.6,29.3,11320,12798,3613,31.92,0.2,1.51,0.986
"842","19105",20468,3919,43.6,20686,17.2,42.7,3558,-218,361,10.15,-0.27,-0.27,-0.27
"843","19107",10223,2139,44,10480,19.3,43.6,2023,-257,116,5.73,-0.31,-0.63,-0.502
"844","19109",15166,3406,45.8,15510,21.9,46.9,3397,-344,9,0.26,-0.32,-1.08,-0.776
"845","19111",34785,6637,43.3,35741,17,42.4,6076,-956,561,9.23,-0.24,-0.35,-0.306
"846","19113",220008,32450,37.4,211954,13.1,36.7,27766,8054,4684,16.87,0.35,0.28,0.308
"847","19115",11238,1882,41,11448,15.3,39.3,1752,-210,130,7.42,-0.31,-0.49,-0.418
"848","19117",8600,1796,44.8,8913,20.1,43.8,1792,-313,4,0.22,-0.33,-1.08,-0.78
"849","19119",11745,2038,38,11623,16.9,38.3,1964,122,74,3.77,-0.31,-0.79,-0.598
"850","19121",15720,2540,40.8,15630,14.9,39.4,2329,90,211,9.06,-0.3,-0.36,-0.336
"851","19123",22301,3891,39.7,22432,16,39.3,3589,-131,302,8.41,-0.28,-0.41,-0.358
"852","19125",33127,5626,39.5,33388,15.8,38.8,5275,-261,351,6.65,-0.27,-0.56,-0.444
"853","19127",40476,6988,38.5,40568,16.4,39.4,6653,-92,335,5.04,-0.28,-0.69,-0.526
"854","19129",14933,2500,42.1,15028,13.9,41.4,2089,-95,411,19.67,-0.27,0.51,0.198
"855","19131",10663,2309,43.7,10761,21.7,44.6,2335,-98,-26,-1.11,-0.33,-1.19,-0.846
"856","19133",8865,2143,46.7,9242,23.8,46.8,2200,-377,-57,-2.59,-0.33,-1.31,-0.918
"857","19135",7912,1493,42.2,7979,18.5,43.3,1476,-67,17,1.15,-0.32,-1.01,-0.734
"858","19137",10239,2106,44.5,10710,20.2,45.2,2163,-471,-57,-2.64,-0.33,-1.32,-0.924
"859","19139",42923,6627,38.1,42729,13.7,38,5854,194,773,13.2,-0.21,-0.02,-0.096
"860","19141",13944,2865,43.3,14302,20.7,44.4,2961,-358,-96,-3.24,-0.34,-1.37,-0.958
"861","19143",6149,1251,44,6413,20.1,43.3,1289,-264,-38,-2.95,-0.33,-1.34,-0.936
"862","19145",15393,3175,44.4,15902,19.9,43.8,3164,-509,11,0.35,-0.32,-1.07,-0.77
"863","19147",9110,1924,42.3,9402,20.9,42.8,1965,-292,-41,-2.09,-0.33,-1.27,-0.894
"864","19149",25027,4460,40.5,24911,16.8,42.5,4185,116,275,6.57,-0.29,-0.56,-0.452
"865","19151",6972,1557,47.2,7307,22.3,47.3,1629,-335,-72,-4.42,-0.34,-1.46,-1.012
"866","19153",467235,56639,35.2,431811,10.9,34.7,47067,35424,9572,20.34,1.06,0.57,0.766
"867","19155",93287,15080,39.6,92793,14.3,38.5,13269,494,1811,13.65,-0.06,0.02,-0.012
"868","19157",18428,3573,40.7,18888,18.7,41.3,3532,-460,41,1.16,-0.32,-1.01,-0.734
"869","19159",4986,1194,45,5123,23.5,45.4,1204,-137,-10,-0.83,-0.33,-1.17,-0.834
"870","19161",9936,2222,45.9,10307,22.2,46.3,2288,-371,-66,-2.88,-0.34,-1.34,-0.94
"871","19163",171493,25577,38.1,165432,13.2,37.4,21837,6061,3740,17.13,0.22,0.3,0.268
"872","19165",11772,2616,46.9,12158,21.4,45.8,2602,-386,14,0.54,-0.32,-1.06,-0.764
"873","19167",34692,5071,33.3,33776,14.3,32.9,4830,916,241,4.99,-0.29,-0.69,-0.53
"874","19169",95888,10568,25.9,89734,10,26.5,8973,6154,1595,17.78,-0.09,0.36,0.18
"875","19171",17236,3289,43.2,17746,18.4,42.1,3265,-510,24,0.74,-0.32,-1.04,-0.752
"876","19173",6214,1330,43.3,6292,21,44.3,1321,-78,9,0.68,-0.32,-1.05,-0.758
"877","19175",12497,2407,40.1,12525,18,41.5,2254,-28,153,6.79,-0.3,-0.54,-0.444
"878","19177",7308,1520,44,7565,20,43.8,1513,-257,7,0.46,-0.32,-1.06,-0.764
"879","19179",35321,5980,39.5,35449,16.3,39.9,5778,-128,202,3.5,-0.3,-0.81,-0.606
"880","19181",48630,7264,38.2,46239,13.4,38.5,6196,2391,1068,17.24,-0.17,0.31,0.118
"881","19183",22095,4056,40.8,21765,17.4,41.9,3787,330,269,7.1,-0.29,-0.52,-0.428
"882","19185",6405,1424,43.3,6372,22.6,45.4,1440,33,-16,-1.11,-0.33,-1.19,-0.846
"883","19187",36945,6396,39.6,37895,16.7,40,6328,-950,68,1.07,-0.32,-1.01,-0.734
"884","19189",10545,2113,42.5,10800,19.5,43.8,2106,-255,7,0.33,-0.32,-1.07,-0.77
"885","19191",20575,3843,41,21033,16.8,40.2,3534,-458,309,8.74,-0.28,-0.39,-0.346
"886","19193",102397,14481,35.6,101948,12.9,35.2,13151,449,1330,10.11,-0.13,-0.27,-0.214
"887","19195",7502,1463,44.4,7581,18.6,43.9,1410,-79,53,3.76,-0.32,-0.79,-0.602
"888","19197",12864,2750,44.3,13173,20.8,44.4,2740,-309,10,0.36,-0.32,-1.07,-0.77
"889","20001",12752,2502,41.6,13364,18.5,40.8,2472,-612,30,1.21,-0.32,-1,-0.728
"890","20003",7840,1662,42.2,8066,20,43,1613,-226,49,3.04,-0.32,-0.85,-0.638
"891","20005",16466,2732,35.9,16854,15.2,35.8,2562,-388,170,6.64,-0.3,-0.56,-0.456
"892","20007",4905,1036,43.4,4867,20.1,46.4,978,38,58,5.93,-0.32,-0.62,-0.5
"893","20009",27067,4820,39.6,27556,17.1,40,4712,-489,108,2.29,-0.31,-0.91,-0.67
"894","20011",14757,2748,39.3,15060,17.9,38,2696,-303,52,1.93,-0.32,-0.94,-0.692
"895","20013",9736,1833,42.2,9962,18.2,41.9,1813,-226,20,1.1,-0.32,-1.01,-0.734
"896","20015",66260,9282,38.1,65647,12.7,37.5,8337,613,945,11.34,-0.19,-0.17,-0.178
"897","20017",2665,626,45,2788,21,45.5,585,-123,41,7.01,-0.32,-0.53,-0.446
"898","20019",3425,857,48.7,3654,25.2,48.3,921,-229,-64,-6.95,-0.33,-1.67,-1.134
"899","20021",20501,3695,41.4,21521,16.3,40.5,3508,-1020,187,5.33,-0.3,-0.66,-0.516
"900","20023",2677,716,47.8,2724,26.1,49.7,711,-47,5,0.7,-0.32,-1.04,-0.752
"901","20025",2089,450,44.2,2198,24.7,43.5,543,-109,-93,-17.13,-0.34,-2.5,-1.636
"902","20027",8203,1861,43,8547,20.4,44.1,1744,-344,117,6.71,-0.31,-0.55,-0.454
"903","20029",9191,1885,41.8,9479,21.1,43.3,2000,-288,-115,-5.75,-0.34,-1.57,-1.078
"904","20031",8328,1654,44,8553,17.6,44,1505,-225,149,9.9,-0.3,-0.29,-0.294
"905","20033",1741,434,49.5,1893,23.9,44,452,-152,-18,-3.98,-0.33,-1.43,-0.99
"906","20035",35732,6173,38.2,36259,15.7,38.4,5693,-527,480,8.43,-0.26,-0.41,-0.35
"907","20037",39099,5837,32.5,39133,14,32.7,5479,-34,358,6.53,-0.27,-0.57,-0.45
"908","20039",2891,785,51.3,2939,26.9,51.4,791,-48,-6,-0.76,-0.33,-1.16,-0.828
"909","20041",19162,3566,41.2,19766,18,41.6,3558,-604,8,0.22,-0.32,-1.08,-0.776
"910","20043",7790,1388,39.4,7931,16,37.9,1269,-141,119,9.38,-0.31,-0.33,-0.322
"911","20045",117806,12728,29.2,111073,9,28.3,9997,6733,2731,27.32,0.07,1.14,0.712
"912","20047",2946,580,44.8,3021,18.9,43.6,571,-75,9,1.58,-0.32,-0.97,-0.71
"913","20049",2581,730,50.8,2856,24.9,49,711,-275,19,2.67,-0.32,-0.88,-0.656
"914","20051",28877,4102,32,28525,13.4,31.8,3822,352,280,7.33,-0.29,-0.5,-0.416
"915","20053",6331,1287,43.7,6477,18.9,44.2,1224,-146,63,5.15,-0.32,-0.68,-0.536
"916","20055",37097,3655,30.6,36608,8.5,30.4,3112,489,543,17.45,-0.25,0.33,0.098
"917","20057",34658,3609,31.1,33725,9.8,30.5,3305,933,304,9.2,-0.28,-0.35,-0.322
"918","20059",25599,4068,40,25916,14.2,38.6,3680,-317,388,10.54,-0.27,-0.24,-0.252
"919","20061",35796,2805,26.4,34110,7.5,27.4,2558,1686,247,9.66,-0.29,-0.31,-0.302
"920","20063",2632,694,48.5,2771,23,48.2,637,-139,57,8.95,-0.32,-0.37,-0.35
"921","20065",2561,657,50.8,2617,25.6,49.5,670,-56,-13,-1.94,-0.33,-1.26,-0.888
"922","20067",7716,880,32.6,7817,10.5,32.6,821,-101,59,7.19,-0.32,-0.51,-0.434
"923","20069",6004,883,35.9,5982,12.7,35.2,760,22,123,16.18,-0.31,0.22,0.00800000000000001
"924","20071",1210,266,48.7,1234,23.7,49.2,292,-24,-26,-8.9,-0.33,-1.83,-1.23
"925","20073",6227,1518,48.6,6654,22,46.5,1464,-427,54,3.69,-0.32,-0.8,-0.608
"926","20075",2621,318,33.4,2656,14.6,36.7,388,-35,-70,-18.04,-0.34,-2.58,-1.684
"927","20077",5746,1238,42.5,5998,21.2,43.3,1272,-252,-34,-2.67,-0.33,-1.32,-0.924
"928","20079",34683,6374,39.2,34572,17.2,39.7,5946,111,428,7.2,-0.26,-0.51,-0.41
"929","20081",4081,563,36.1,4222,11.8,34.3,498,-141,65,13.05,-0.32,-0.03,-0.146
"930","20083",1875,411,46.8,1949,22.5,47.9,439,-74,-28,-6.38,-0.33,-1.62,-1.104
"931","20085",13322,2367,41.4,13401,15.6,41.3,2091,-79,276,13.2,-0.29,-0.02,-0.128
"932","20087",18856,3348,44,19036,15.6,42.9,2970,-180,378,12.73,-0.27,-0.06,-0.144
"933","20089",2963,841,51.9,3085,27.5,51.7,848,-122,-7,-0.83,-0.33,-1.17,-0.834
"934","20091",578797,75988,37.3,546046,11.1,36.4,60611,32751,15377,25.37,1.9,0.98,1.348
"935","20093",3931,544,34.8,3952,13,35.7,514,-21,30,5.84,-0.32,-0.62,-0.5
"936","20095",7576,1620,45.5,7876,20.7,44.6,1630,-300,-10,-0.61,-0.33,-1.15,-0.822
"937","20097",2524,502,40.8,2503,19.1,42.3,478,21,24,5.02,-0.32,-0.69,-0.542
"938","20099",20553,3719,41,21574,16.6,40.3,3581,-1021,138,3.85,-0.31,-0.79,-0.598
"939","20101",1702,341,41.5,1666,22.4,45.3,373,36,-32,-8.58,-0.33,-1.8,-1.212
"940","20103",79359,10449,37.3,76286,11.2,37.4,8544,3073,1905,22.3,-0.05,0.73,0.418
"941","20105",3121,716,46.6,3240,20.2,46.3,654,-119,62,9.48,-0.32,-0.32,-0.32
"942","20107",9602,2032,43.6,9613,19.4,44.3,1865,-11,167,8.95,-0.3,-0.37,-0.342
"943","20109",2790,575,40.4,2766,20.8,44.3,575,24,0,0,-0.33,-1.1,-0.792
"944","20111",33302,4602,32.9,34103,12.2,32.2,4161,-801,441,10.6,-0.26,-0.23,-0.242
"945","20113",28792,5438,40.8,29208,18.3,41.8,5345,-416,93,1.74,-0.31,-0.96,-0.7
"946","20115",12087,2734,45,12565,21,44.3,2639,-478,95,3.6,-0.31,-0.81,-0.61
"947","20117",9859,2061,44,10083,20.9,44.9,2107,-224,-46,-2.18,-0.33,-1.28,-0.9
"948","20119",4295,742,37.7,4504,16.2,40,730,-209,12,1.64,-0.32,-0.97,-0.71
"949","20121",32976,5440,41.7,32546,13.2,40.1,4296,430,1144,26.63,-0.16,1.08,0.584
"950","20123",6230,1415,43.7,6359,21.5,45.1,1367,-129,48,3.51,-0.32,-0.81,-0.614
"951","20125",33463,6285,40.3,35167,17.4,39.7,6119,-1704,166,2.71,-0.3,-0.88,-0.648
"952","20127",5605,1343,47.9,5917,22,47.3,1302,-312,41,3.15,-0.32,-0.84,-0.632
"953","20129",2931,510,39.5,3207,17.5,39.4,561,-276,-51,-9.09,-0.33,-1.85,-1.242
"954","20131",10095,1975,40.4,10170,20.5,42.4,2085,-75,-110,-5.28,-0.34,-1.53,-1.054
"955","20133",16209,2997,39.7,16501,17.4,40.2,2871,-292,126,4.39,-0.31,-0.74,-0.568
"956","20135",3001,739,47.2,3102,25.1,50.9,779,-101,-40,-5.13,-0.33,-1.52,-1.044
"957","20137",5527,1090,43.5,5658,19.5,43.4,1103,-131,-13,-1.18,-0.33,-1.2,-0.852
"958","20139",15894,2999,43.4,16300,16.8,42.6,2738,-406,261,9.53,-0.29,-0.32,-0.308
"959","20141",3684,888,47.4,3852,25.4,47.6,978,-168,-90,-9.2,-0.34,-1.85,-1.246
"960","20143",5957,1116,42.4,6099,17.4,42.3,1061,-142,55,5.18,-0.32,-0.68,-0.536
"961","20145",6776,1344,44.5,6945,17.2,42,1195,-169,149,12.47,-0.3,-0.08,-0.168
"962","20147",5446,1184,44.3,5579,20.6,45.7,1149,-133,35,3.05,-0.32,-0.85,-0.638
"963","20149",23188,3099,35.2,21620,12.4,35.1,2681,1568,418,15.59,-0.27,0.18,-1.38777878078145e-17
"964","20151",9670,1759,39.2,9670,18.4,40.5,1779,0,-20,-1.12,-0.33,-1.19,-0.846
"965","20153",2520,664,50.3,2555,26.8,50.8,685,-35,-21,-3.07,-0.33,-1.35,-0.942
"966","20155",63360,11670,40.1,64346,17,40,10939,-986,731,6.68,-0.22,-0.55,-0.418
"967","20157",4705,1282,50.9,4965,27.1,50.8,1346,-260,-64,-4.75,-0.33,-1.49,-1.026
"968","20159",9868,1759,38.5,10077,17.9,38.7,1804,-209,-45,-2.49,-0.33,-1.31,-0.918
"969","20161",75696,6256,24.9,71927,7.2,24.3,5179,3769,1077,20.8,-0.17,0.6,0.292
"970","20163",5148,1084,43.6,5205,20,44.4,1041,-57,43,4.13,-0.32,-0.76,-0.584
"971","20165",3119,763,47.9,3262,23.6,49,770,-143,-7,-0.91,-0.33,-1.18,-0.84
"972","20167",6987,1646,48.7,6926,23.9,47.1,1655,61,-9,-0.54,-0.33,-1.15,-0.822
"973","20169",55334,8959,37.9,55493,14.8,37.9,8213,-159,746,9.08,-0.22,-0.36,-0.304
"974","20171",4981,845,40.5,4872,17.4,43.8,848,109,-3,-0.35,-0.33,-1.13,-0.81
"975","20173",510484,67517,35,497062,11.6,34.4,57659,13422,9858,17.1,1.1,0.3,0.62
"976","20175",22948,2182,29.5,23013,8.5,29,1956,-65,226,11.55,-0.29,-0.15,-0.206
"977","20177",178392,29543,38.9,177688,14.5,38.4,25765,704,3778,14.66,0.22,0.1,0.148
"978","20179",2497,562,44.7,2562,22.4,46.6,574,-65,-12,-2.09,-0.33,-1.27,-0.894
"979","20181",5999,1140,38.5,6036,18.7,41.1,1129,-37,11,0.97,-0.32,-1.02,-0.74
"980","20183",3693,995,51.6,3835,27.4,50.4,1051,-142,-56,-5.33,-0.33,-1.54,-1.056
"981","20185",4251,871,42.7,4398,21.1,45.7,928,-147,-57,-6.14,-0.33,-1.6,-1.092
"982","20187",2107,392,39.3,2200,15,35.5,330,-93,62,18.79,-0.32,0.44,0.136
"983","20189",5741,740,35.1,5633,13.2,34.8,744,108,-4,-0.54,-0.33,-1.15,-0.822
"984","20191",23336,4067,40.7,24000,15.4,39.9,3696,-664,371,10.04,-0.27,-0.28,-0.276
"985","20193",7847,1257,36.3,7854,15,36.2,1178,-7,79,6.71,-0.31,-0.55,-0.454
"986","20195",2899,659,49.4,2977,22.7,46.8,676,-78,-17,-2.51,-0.33,-1.31,-0.918
"987","20197",6918,1250,43.4,7048,15.6,41.6,1099,-130,151,13.74,-0.3,0.02,-0.108
"988","20199",1591,327,40.6,1508,19.2,45.1,290,83,37,12.76,-0.32,-0.06,-0.164
"989","20201",5572,1333,46.2,5806,23.1,46,1341,-234,-8,-0.6,-0.33,-1.15,-0.822
"990","20203",2157,424,41.2,2239,17,38.3,381,-82,43,11.29,-0.32,-0.18,-0.236
"991","20205",8858,1814,44,9368,19.3,44.1,1808,-510,6,0.33,-0.32,-1.07,-0.77
"992","20207",3178,741,48.6,3311,22.5,48.8,745,-133,-4,-0.54,-0.33,-1.15,-0.822
"993","20209",163227,18821,33.7,157274,10.8,33,16986,5953,1835,10.8,-0.06,-0.22,-0.156
"994","21001",19304,3272,40.8,18651,16,39.4,2984,653,288,9.65,-0.28,-0.31,-0.298
"995","21003",20628,3395,40.6,20007,14.8,39.3,2961,621,434,14.66,-0.26,0.1,-0.044
"996","21005",22017,3191,40.5,21442,12.5,38.3,2680,575,511,19.07,-0.25,0.46,0.176
"997","21007",8152,1581,43.3,8268,17.6,41.6,1455,-116,126,8.66,-0.31,-0.39,-0.358
"998","21009",43418,7328,40.3,42229,15.6,39.9,6588,1189,740,11.23,-0.22,-0.18,-0.196
"999","21011",12189,1937,39.9,11665,14.8,40.4,1726,524,211,12.22,-0.3,-0.1,-0.18
"1000","21013",27469,4914,41.6,28613,15.6,41.1,4464,-1144,450,10.08,-0.26,-0.28,-0.272
"1001","21015",127682,15414,37.1,119406,9.7,35.7,11582,8276,3832,33.09,0.23,1.61,1.058
"1002","21017",20017,3595,42.1,20004,15.9,40.4,3181,13,414,13.01,-0.27,-0.04,-0.132
"1003","21019",48486,8858,41.9,49358,16.8,41.6,8292,-872,566,6.83,-0.24,-0.54,-0.42
"1004","21021",29773,5298,40.2,28445,16.3,40.8,4637,1328,661,14.25,-0.23,0.07,-0.05
"1005","21023",8330,1278,40.7,8488,13.7,39.7,1163,-158,115,9.89,-0.31,-0.29,-0.298
"1006","21025",13276,2038,41.2,13922,13.6,40.4,1893,-646,145,7.66,-0.3,-0.47,-0.402
"1007","21027",19991,3664,43.3,20068,15.8,41.8,3171,-77,493,15.55,-0.25,0.17,0.002
"1008","21029",78622,11273,39.8,74431,11.3,38.2,8411,4191,2862,34.03,0.09,1.69,1.05
"1009","21031",12735,2227,41.2,12748,15.7,40.3,2001,-13,226,11.29,-0.29,-0.18,-0.224
"1010","21033",12747,2481,42.6,12977,18.1,42.2,2349,-230,132,5.62,-0.31,-0.64,-0.508
"1011","21035",38616,6318,34.7,37198,15.1,33.6,5617,1418,701,12.48,-0.22,-0.08,-0.136
"1012","21037",91804,13264,38,90119,13,36.9,11715,1685,1549,13.22,-0.1,-0.02,-0.052
"1013","21039",4890,979,42.2,5081,19.2,43.2,976,-191,3,0.31,-0.33,-1.08,-0.78
"1014","21041",10695,1598,37.2,10851,13.2,36.6,1432,-156,166,11.59,-0.3,-0.15,-0.21
"1015","21043",27385,4752,41.1,27594,15.1,39.2,4167,-209,585,14.04,-0.24,0.05,-0.066
"1016","21045",15805,3045,43.1,15984,16.5,41.1,2637,-179,408,15.47,-0.27,0.17,-0.00600000000000001
"1017","21047",72438,8273,28.4,73722,10.3,28.9,7593,-1284,680,8.96,-0.23,-0.37,-0.314
"1018","21049",35757,6053,42.3,35555,14.4,40.3,5120,202,933,18.22,-0.19,0.39,0.158
"1019","21051",20866,2874,39.2,21833,12,37.4,2620,-967,254,9.69,-0.29,-0.31,-0.302
"1020","21053",10208,1885,41.7,10244,16.5,41.5,1690,-36,195,11.54,-0.3,-0.16,-0.216
"1021","21055",9154,1798,43.2,9321,18.3,42.4,1706,-167,92,5.39,-0.31,-0.66,-0.52
"1022","21057",6744,1384,45.1,6857,19.2,43.3,1317,-113,67,5.09,-0.32,-0.68,-0.536
"1023","21059",99258,16101,39,96711,14.8,39,14313,2547,1788,12.49,-0.07,-0.08,-0.076
"1024","21061",12063,2326,43.1,12141,16.7,41.7,2028,-78,298,14.69,-0.28,0.1,-0.052
"1025","21063",7533,1336,42,7774,15.3,40.9,1189,-241,147,12.36,-0.3,-0.09,-0.174
"1026","21065",14382,2531,42.6,14647,15.5,41.7,2270,-265,261,11.5,-0.29,-0.16,-0.212
"1027","21067",315109,38443,34.3,296766,10.6,33.8,31457,18343,6986,22.21,0.69,0.72,0.708
"1028","21069",14515,2406,40.9,14415,14.9,39.9,2148,100,258,12.01,-0.29,-0.12,-0.188
"1029","21071",37447,6101,41.4,39454,13.7,39.9,5405,-2007,696,12.88,-0.22,-0.05,-0.118
"1030","21073",49969,8114,40.7,49399,14.1,39.7,6965,570,1149,16.5,-0.16,0.25,0.086
"1031","21075",6259,1169,43.1,6758,18.1,42.8,1223,-499,-54,-4.42,-0.33,-1.46,-1.008
"1032","21077",8652,1141,39,8513,11.5,39.4,979,139,162,16.55,-0.3,0.25,0.03
"1033","21079",17226,2959,42.4,16892,14.6,41.7,2466,334,493,19.99,-0.25,0.54,0.224
"1034","21081",24800,3231,36.5,24683,10.8,35.3,2666,117,565,21.19,-0.24,0.63,0.282
"1035","21083",37259,6563,40.3,37200,16.3,40,6064,59,499,8.23,-0.25,-0.43,-0.358
"1036","21085",26129,4248,40.2,25772,15.2,39.2,3917,357,331,8.45,-0.28,-0.41,-0.358
"1037","21087",11044,2214,44.4,11309,17.6,43.4,1990,-265,224,11.26,-0.29,-0.18,-0.224
"1038","21089",36012,7092,43.3,36922,17,42,6277,-910,815,12.98,-0.21,-0.04,-0.108
"1039","21091",8700,1420,40.2,8588,14.2,40,1219,112,201,16.49,-0.3,0.25,0.03
"1040","21093",107699,13730,36.1,104513,11,35.5,11496,3186,2234,19.43,0,0.49,0.294
"1041","21095",27548,4593,41.4,29210,14.5,40.6,4235,-1662,358,8.45,-0.27,-0.41,-0.354
"1042","21097",18630,3180,41.8,18781,15.1,41.6,2836,-151,344,12.13,-0.28,-0.11,-0.178
"1043","21099",18531,2988,40.6,18278,15.1,40.6,2760,253,228,8.26,-0.29,-0.42,-0.368
"1044","21101",46252,7463,40.4,46254,14.2,39.4,6568,-2,895,13.63,-0.2,0.02,-0.068
"1045","21103",15677,2525,41.3,15428,14.2,40.6,2191,249,334,15.24,-0.28,0.15,-0.022
"1046","21105",4625,1080,48.3,4869,20.9,44.7,1018,-244,62,6.09,-0.32,-0.6,-0.488
"1047","21107",45985,7844,41.3,46891,15.5,40.3,7268,-906,576,7.93,-0.24,-0.45,-0.366
"1048","21109",13369,2108,41,13475,14.4,39,1940,-106,168,8.66,-0.3,-0.39,-0.354
"1049","21111",764378,114227,38,741285,13.4,37.8,99332,23093,14895,15,1.83,0.13,0.81
"1050","21113",51667,7125,37.4,48591,11.4,35.6,5539,3076,1586,28.63,-0.1,1.24,0.704
"1051","21115",23064,3858,41.9,23339,14.2,39.7,3314,-275,544,16.42,-0.25,0.24,0.044
"1052","21117",163987,21556,36.9,159926,11.3,36.2,18072,4061,3484,19.28,0.18,0.48,0.36
"1053","21119",15690,2531,41.4,16368,13.6,41.1,2226,-678,305,13.7,-0.28,0.02,-0.1
"1054","21121",31424,5190,39.7,31874,14.7,38.8,4685,-450,505,10.78,-0.25,-0.22,-0.232
"1055","21123",14102,2385,40.8,14175,15.4,39.5,2183,-73,202,9.25,-0.3,-0.34,-0.324
"1056","21125",59901,9113,39.6,58891,13.1,37.6,7715,1010,1398,18.12,-0.12,0.38,0.18
"1057","21127",15844,2622,40.9,15889,14.3,39.5,2272,-45,350,15.4,-0.27,0.16,-0.012
"1058","21129",6717,1154,44.2,7831,13.6,41.2,1065,-1114,89,8.36,-0.31,-0.42,-0.376
"1059","21131",10648,1726,41.9,11318,14.2,41.8,1607,-670,119,7.41,-0.31,-0.49,-0.418
"1060","21133",23011,3984,41.8,24336,14.5,41.3,3529,-1325,455,12.89,-0.26,-0.05,-0.134
"1061","21135",13565,2330,42.1,13889,14.9,40.3,2069,-324,261,12.61,-0.29,-0.07,-0.158
"1062","21137",24413,4166,40.6,24671,14.9,39.2,3676,-258,490,13.33,-0.25,-0.01,-0.106
"1063","21139",9288,1867,45.8,9479,18.1,44.7,1716,-191,151,8.8,-0.3,-0.38,-0.348
"1064","21141",26847,4673,40.7,26786,15.6,40.5,4179,61,494,11.82,-0.25,-0.13,-0.178
"1065","21143",8268,1991,49.2,8336,20.9,47.7,1742,-68,249,14.29,-0.29,0.07,-0.074
"1066","21145",65285,12144,42.1,65558,16.8,42.1,11014,-273,1130,10.26,-0.16,-0.26,-0.22
"1067","21147",17748,2565,39.2,18204,12.4,38.6,2257,-456,308,13.65,-0.28,0.02,-0.1
"1068","21149",9361,1749,41.5,9554,17,42.2,1624,-193,125,7.7,-0.31,-0.47,-0.406
"1069","21151",88376,11390,34,83174,11.2,33.6,9315,5202,2075,22.28,-0.03,0.72,0.42
"1070","21153",12783,1968,42,13229,13.3,39.4,1759,-446,209,11.88,-0.3,-0.13,-0.198
"1071","21155",19335,3038,39.7,19872,13.2,38.2,2623,-537,415,15.82,-0.27,0.19,0.00599999999999998
"1072","21157",31177,6610,44.8,31393,19.4,43.9,6090,-216,520,8.54,-0.25,-0.4,-0.34
"1073","21159",12175,1717,39,12934,11.5,38.6,1487,-759,230,15.47,-0.29,0.17,-0.014
"1074","21161",17167,2916,40.7,17495,14.7,40.8,2572,-328,344,13.37,-0.28,-0.01,-0.118
"1075","21163",28452,3703,37.8,28979,10.4,35.6,3014,-527,689,22.86,-0.23,0.77,0.37
"1076","21165",6381,1310,46.2,6331,14.8,41.6,937,50,373,39.81,-0.27,2.16,1.188
"1077","21167",21378,3780,42.8,21283,16.4,42.3,3490,95,290,8.31,-0.28,-0.42,-0.364
"1078","21169",9990,1805,43.1,10074,16.6,41.9,1672,-84,133,7.95,-0.31,-0.45,-0.394
"1079","21171",10645,1940,41.8,10925,17.3,42.1,1890,-280,50,2.65,-0.32,-0.88,-0.656
"1080","21173",27550,4135,39,26517,13.1,37.3,3474,1033,661,19.03,-0.23,0.46,0.184
"1081","21175",13281,2011,41.3,13898,13.1,38.6,1821,-617,190,10.43,-0.3,-0.25,-0.27
"1082","21177",31153,5626,42,31399,16.4,41,5149,-246,477,9.26,-0.26,-0.34,-0.308
"1083","21179",45131,6358,38.9,43500,11.7,37.5,5090,1631,1268,24.91,-0.14,0.94,0.508
"1084","21181",7061,1176,41.6,7092,15.8,39.4,1121,-31,55,4.91,-0.32,-0.7,-0.548
"1085","21183",24062,4224,40.7,23975,15.3,39,3668,87,556,15.16,-0.25,0.14,-0.016
"1086","21185",64633,7728,39,60357,9.5,39.2,5734,4276,1994,34.78,-0.04,1.75,1.034
"1087","21187",10686,1883,42.2,10870,14.4,40.6,1565,-184,318,20.32,-0.28,0.56,0.224
"1088","21189",4497,744,41.8,4764,19.6,43.9,934,-267,-190,-20.34,-0.35,-2.77,-1.802
"1089","21191",14530,2151,41.2,14771,12.5,39.4,1846,-241,305,16.52,-0.28,0.25,0.038
"1090","21193",27329,4115,41.2,28617,13.3,41.2,3806,-1288,309,8.12,-0.28,-0.44,-0.376
"1091","21195",61586,10292,41.9,64887,14,40.5,9084,-3301,1208,13.3,-0.15,-0.01,-0.066
"1092","21197",12349,1754,39,12638,13.1,37.9,1656,-289,98,5.92,-0.31,-0.62,-0.496
"1093","21199",63974,11508,42,63045,16.5,40.9,10402,929,1106,10.63,-0.17,-0.23,-0.206
"1094","21201",2161,476,47.1,2251,17.2,38.6,387,-90,89,23,-0.31,0.78,0.344
"1095","21203",16815,2854,42.2,17090,15.2,41.3,2598,-275,256,9.85,-0.29,-0.29,-0.29
"1096","21205",24392,3181,30.7,23351,12.4,32,2896,1041,285,9.84,-0.28,-0.3,-0.292
"1097","21207",17731,3356,43.4,17562,17.9,41.2,3144,169,212,6.74,-0.29,-0.55,-0.446
"1098","21209",52322,5826,36.2,47211,9.3,35.2,4391,5111,1435,32.68,-0.12,1.58,0.9
"1099","21211",45831,6572,38.8,42286,12.2,38.2,5159,3545,1413,27.39,-0.12,1.14,0.636
"1100","21213",17881,2784,39.8,17323,14,38.4,2425,558,359,14.8,-0.27,0.11,-0.042
"1101","21215",18012,2284,40.7,17135,10.6,39.4,1816,877,468,25.77,-0.26,1.01,0.502
"1102","21217",25406,4342,38.4,24514,16.1,40.2,3947,892,395,10.01,-0.27,-0.28,-0.276
"1103","21219",12377,1937,36.8,12472,14.7,38,1833,-95,104,5.67,-0.31,-0.64,-0.508
"1104","21221",14286,3154,45.5,14282,18.5,44.3,2642,4,512,19.38,-0.25,0.49,0.194
"1105","21223",8697,1479,41.9,8829,13.3,39.5,1174,-132,305,25.98,-0.28,1.03,0.506
"1106","21225",14915,2271,37.5,14992,14.2,36.6,2129,-77,142,6.67,-0.31,-0.55,-0.454
"1107","21227",123824,15115,32.7,113787,11,32.7,12517,10037,2598,20.76,0.05,0.6,0.38
"1108","21229",11999,2047,41.2,11701,16,40.9,1872,298,175,9.35,-0.3,-0.34,-0.324
"1109","21231",20692,3925,42,20819,16.7,40.9,3477,-127,448,12.88,-0.26,-0.05,-0.134
"1110","21233",13180,2194,41,13618,14.7,39.7,2002,-438,192,9.59,-0.3,-0.32,-0.312
"1111","21235",36027,5603,37,35756,14,37.9,5006,271,597,11.93,-0.24,-0.12,-0.168
"1112","21237",7251,1326,41.8,7298,15.8,41.3,1153,-47,173,15,-0.3,0.13,-0.042
"1113","21239",25817,4269,42.3,24847,13.2,41.7,3280,970,989,30.15,-0.18,1.37,0.75
"1114","22001",62607,8798,35.8,61611,12.7,35.6,7825,996,973,12.43,-0.18,-0.08,-0.12
"1115","22003",25667,3646,38.2,25740,12.7,38.5,3269,-73,377,11.53,-0.27,-0.16,-0.204
"1116","22005",119129,12799,35.3,107647,9,34.4,9688,11482,3111,32.11,0.12,1.53,0.966
"1117","22007",22881,3629,39.5,23321,13.8,38.8,3218,-440,411,12.77,-0.27,-0.05,-0.138
"1118","22009",41095,6468,38.1,41925,14.4,38.5,6037,-830,431,7.14,-0.26,-0.52,-0.416
"1119","22011",36598,5438,37.5,35662,13,37.4,4636,936,802,17.3,-0.21,0.32,0.108
"1120","22013",13806,2665,42.3,14312,18.5,41.3,2648,-506,17,0.64,-0.32,-1.05,-0.758
"1121","22015",125698,16497,34.9,117742,11.9,34.6,14011,7956,2486,17.74,0.03,0.35,0.222
"1122","22017",251069,38735,37.1,254970,13.6,36.3,34676,-3901,4059,11.71,0.26,-0.14,0.02
"1123","22019",198753,27718,36.1,192307,12.7,35.9,24423,6446,3295,13.49,0.15,0,0.06
"1124","22021",10000,1723,39.9,10118,15.2,40.4,1538,-118,185,12.03,-0.3,-0.12,-0.192
"1125","22023",6806,1063,43.2,6934,12.7,40.3,881,-128,182,20.66,-0.3,0.59,0.234
"1126","22025",10044,1593,38,10409,14.7,37.3,1530,-365,63,4.12,-0.32,-0.76,-0.584
"1127","22027",16296,2963,42.2,17059,16.4,41.8,2798,-763,165,5.9,-0.3,-0.62,-0.492
"1128","22029",20211,3262,37.7,20624,14.8,37.5,3052,-413,210,6.88,-0.3,-0.54,-0.444
"1129","22031",27164,4484,39.4,26695,14.5,39.9,3871,469,613,15.84,-0.24,0.2,0.024
"1130","22033",446167,57209,33.4,439662,11.1,32.7,48802,6505,8407,17.23,0.89,0.31,0.542
"1131","22035",7318,950,33.8,7738,13,33.1,1006,-420,-56,-5.57,-0.33,-1.56,-1.068
"1132","22037",19553,3133,42.4,20252,13.3,40.6,2694,-699,439,16.3,-0.26,0.23,0.034
"1133","22039",33750,4910,35.4,33989,13.2,35.7,4487,-239,423,9.43,-0.26,-0.33,-0.302
"1134","22041",20388,3497,38,20714,16.4,38.8,3397,-326,100,2.94,-0.31,-0.86,-0.64
"1135","22043",22305,3114,37.7,22049,12.2,37.4,2690,256,424,15.76,-0.26,0.19,0.00999999999999998
"1136","22045",73346,10069,36,73527,12.3,35.6,9044,-181,1025,11.33,-0.18,-0.17,-0.174
"1137","22047",33122,4755,38.4,33386,12.2,38.1,4073,-264,682,16.74,-0.23,0.27,0.07
"1138","22049",15952,3011,40.5,16210,16.7,39.1,2707,-258,304,11.23,-0.28,-0.18,-0.22
"1139","22051",437038,68345,39,432706,13.8,38.5,59713,4332,8632,14.46,0.92,0.08,0.416
"1140","22053",31405,4894,38.1,31529,14.5,38,4572,-124,322,7.04,-0.28,-0.52,-0.424
"1141","22055",238230,28017,34.5,221602,10.4,33.6,23047,16628,4970,21.56,0.39,0.67,0.558
"1142","22057",98112,13917,37.1,96453,12.7,36.7,12250,1659,1667,13.61,-0.08,0.01,-0.026
"1143","22059",14930,2385,38.2,14840,14.6,38.3,2167,90,218,10.06,-0.29,-0.28,-0.284
"1144","22061",47536,5993,27.6,46543,11.4,27.8,5306,993,687,12.95,-0.23,-0.04,-0.116
"1145","22063",137096,16696,35.9,128192,10.1,34.7,12947,8904,3749,28.96,0.22,1.27,0.85
"1146","22065",11616,1530,35.1,12113,11.7,34.9,1417,-497,113,7.97,-0.31,-0.45,-0.394
"1147","22067",26290,4520,39.6,27893,15.5,38.1,4323,-1603,197,4.56,-0.3,-0.73,-0.558
"1148","22069",39051,6006,33.6,39434,13.6,33.3,5363,-383,643,11.99,-0.23,-0.12,-0.164
"1149","22071",388182,50009,35.9,341407,11.1,34.9,37896,46775,12113,31.96,1.43,1.52,1.484
"1150","22073",156433,21271,35.1,153752,12.4,34.2,19065,2681,2206,11.57,-0.01,-0.15,-0.094
"1151","22075",23394,2782,35.9,23220,11.1,36.6,2577,174,205,7.95,-0.3,-0.45,-0.39
"1152","22077",22271,4159,42.7,22821,15.9,42.5,3629,-550,530,14.6,-0.25,0.09,-0.046
"1153","22079",132080,20016,37.3,131655,13.7,37.4,18037,425,1979,10.97,-0.04,-0.2,-0.136
"1154","22081",8723,1550,39.9,9068,15.4,38.3,1396,-345,154,11.03,-0.3,-0.2,-0.24
"1155","22083",20619,3330,38.2,20785,14.4,38.2,2993,-166,337,11.26,-0.28,-0.18,-0.22
"1156","22085",24145,4632,41.3,24265,17.3,40.9,4198,-120,434,10.34,-0.26,-0.25,-0.254
"1157","22087",45067,4629,33.6,35947,9.4,33.2,3379,9120,1250,36.99,-0.14,1.93,1.102
"1158","22089",52728,6227,37.2,52663,10.1,36.7,5319,65,908,17.07,-0.19,0.3,0.104
"1159","22091",10509,1840,38.3,11106,14.5,39.2,1610,-597,230,14.29,-0.29,0.07,-0.074
"1160","22093",21485,3304,38.9,21978,13.2,38.6,2901,-493,403,13.89,-0.27,0.04,-0.084
"1161","22095",43565,5505,36.5,45741,10.3,35.3,4711,-2176,794,16.85,-0.21,0.28,0.084
"1162","22097",83580,12591,36.2,83774,13.7,36.9,11477,-194,1114,9.71,-0.16,-0.31,-0.25
"1163","22099",53609,7262,37.1,52343,11.7,36,6124,1266,1138,18.58,-0.16,0.42,0.188
"1164","22101",52578,7829,38,54285,13.1,37.4,7111,-1707,718,10.1,-0.22,-0.27,-0.25
"1165","22103",249201,38299,39.8,234283,12.8,39.4,29988,14918,8311,27.71,0.88,1.17,1.054
"1166","22105",128850,17083,34.9,121209,11.5,33.5,13939,7641,3144,22.56,0.13,0.75,0.502
"1167","22107",4771,1044,44,5189,17.5,41.9,908,-418,136,14.98,-0.31,0.13,-0.046
"1168","22109",113067,14611,35.5,111666,11.4,35.1,12730,1401,1881,14.78,-0.05,0.11,0.046
"1169","22111",22537,4292,41.7,22633,16.7,40.9,3780,-96,512,13.54,-0.25,0.01,-0.094
"1170","22113",59841,8551,36.9,58041,13,36.7,7545,1800,1006,13.33,-0.18,-0.01,-0.078
"1171","22115",51906,5636,30.1,51542,9.6,30,4948,364,688,13.9,-0.23,0.04,-0.068
"1172","22117",46449,7803,39.9,47025,14.6,38.8,6866,-576,937,13.65,-0.19,0.02,-0.064
"1173","22119",40043,7375,40.6,41156,16.9,40.4,6955,-1113,420,6.04,-0.26,-0.61,-0.47
"1174","22121",25518,3203,35.6,23748,11,35.8,2612,1770,591,22.63,-0.24,0.75,0.354
"1175","22123",11274,2062,41,11587,16.9,40.1,1958,-313,104,5.31,-0.31,-0.67,-0.526
"1176","22125",15376,2027,40.5,15575,10.4,42.2,1620,-199,407,25.12,-0.27,0.96,0.468
"1177","22127",14631,2494,40.9,15233,14.4,39.9,2194,-602,300,13.67,-0.28,0.02,-0.1
"1178","23001",107317,17543,40.7,107766,14.2,39.8,15303,-449,2240,14.64,0,0.1,0.06
"1179","23003",68840,15138,47.2,71757,19.1,45.2,13706,-2917,1432,10.45,-0.12,-0.25,-0.198
"1180","23005",289173,48521,42.1,282143,14.4,41.1,40629,7030,7892,19.42,0.82,0.49,0.622
"1181","23007",30177,6100,45.4,30704,16.8,43.3,5158,-527,942,18.26,-0.19,0.39,0.158
"1182","23009",54468,12158,48.1,54470,18.4,46.3,10022,-2,2136,21.31,-0.02,0.64,0.376
"1183","23011",121289,22066,44.2,122022,15.7,42.7,19157,-733,2909,15.19,0.1,0.14,0.124
"1184","23013",39700,9102,47.8,39848,19.5,46.6,7770,-148,1332,17.14,-0.13,0.3,0.128
"1185","23015",34021,8761,50.5,34440,21.7,48.1,7473,-419,1288,17.24,-0.14,0.31,0.13
"1186","23017",57230,11325,46.3,57814,17.1,44.4,9886,-584,1439,14.56,-0.12,0.09,0.006
"1187","23019",152284,25664,41.8,153742,14.6,40,22446,-1458,3218,14.34,0.14,0.07,0.098
"1188","23021",16960,4164,50.7,17432,20.5,48.1,3574,-472,590,16.51,-0.24,0.25,0.054
"1189","23023",35149,7026,45.9,35394,16.3,43.8,5769,-245,1257,21.79,-0.14,0.68,0.352
"1190","23025",50994,9921,45.8,52098,16.5,43.9,8596,-1104,1325,15.41,-0.13,0.16,0.044
"1191","23027",39280,7963,45.7,38761,16.4,44.2,6357,519,1606,25.26,-0.09,0.97,0.546
"1192","23029",31822,7218,47.6,32832,19.6,45.9,6435,-1010,783,12.17,-0.21,-0.1,-0.144
"1193","23031",201454,37461,44.7,197861,15.6,43,30866,3593,6595,21.37,0.63,0.65,0.642
"1194","24001",72591,14022,41.5,74645,18.1,41,13511,-2054,511,3.78,-0.25,-0.79,-0.574
"1195","24003",564600,77681,38.5,538473,12,38.4,64617,26127,13064,20.22,1.57,0.56,0.964
"1196","24005",828637,133437,39.2,807318,14.7,39,118676,21319,14761,12.44,1.81,-0.08,0.676
"1197","24009",90824,12382,40.8,88774,11,39.8,9765,2050,2617,26.8,0.05,1.09,0.674
"1198","24011",32785,5062,40.1,32947,13.4,38.9,4415,-162,647,14.65,-0.23,0.1,-0.032
"1199","24013",167319,26067,42.4,167249,13.3,41.1,22244,70,3823,17.19,0.23,0.31,0.278
"1200","24015",102416,14748,40.3,101109,11.8,39,11931,1307,2817,23.61,0.08,0.83,0.53
"1201","24017",156021,17753,38.1,147107,9.6,37.2,14122,8914,3631,25.71,0.2,1.01,0.686
"1202","24019",32386,6506,44.4,32570,17.8,42.9,5797,-184,709,12.23,-0.22,-0.1,-0.148
"1203","24021",246105,32870,39.3,234268,11.2,38.5,26238,11837,6632,25.28,0.63,0.97,0.834
"1204","24023",29516,6126,45.4,30079,17.7,42.9,5324,-563,802,15.06,-0.21,0.13,-0.00600000000000001
"1205","24025",250132,37368,40.6,245396,12.6,39.5,30920,4736,6448,20.85,0.61,0.61,0.61
"1206","24027",312495,39232,38.7,288676,10.3,38.3,29734,23819,9498,31.94,1.05,1.52,1.332
"1207","24029",19666,4941,46.9,20184,21.8,45.3,4400,-518,541,12.3,-0.25,-0.09,-0.154
"1208","24031",1039198,146712,38.8,974824,12.4,38.4,120878,64374,25834,21.37,3.42,0.65,1.758
"1209","24033",905161,106530,36.5,865443,9.6,35,83083,39718,23447,28.22,3.07,1.21,1.954
"1210","24035",49071,8753,44.1,47894,15.1,42.2,7232,1177,1521,21.03,-0.11,0.62,0.328
"1211","24037",110979,13184,36.5,105528,10.4,36,10975,5451,2209,20.13,-0.01,0.55,0.326
"1212","24039",25801,3958,37,26402,14.1,36.9,3723,-601,235,6.31,-0.29,-0.58,-0.464
"1213","24041",37461,10073,49.7,37746,24.1,47.3,9097,-285,976,10.73,-0.18,-0.22,-0.204
"1214","24043",149546,23991,40.6,147882,14.4,39.8,21295,1664,2696,12.66,0.06,-0.06,-0.012
"1215","24045",102014,15015,35.8,98940,13.1,35.6,12961,3074,2054,15.85,-0.03,0.2,0.108
"1216","24047",51559,13509,49.7,51398,23.3,48.1,11976,161,1533,12.8,-0.1,-0.05,-0.07
"1217","24510",619796,79265,35,620644,11.7,34.4,72615,-848,6650,9.16,0.64,-0.35,0.046
"1218","25001",213900,60860,52.4,216021,25.1,49.9,54221,-2121,6639,12.24,0.64,-0.1,0.196
"1219","25003",127751,27450,46.5,130866,18.8,44.6,24603,-3115,2847,11.57,0.09,-0.15,-0.054
"1220","25005",557016,89144,40.9,548739,14.3,39.9,78470,8277,10674,13.6,1.22,0.01,0.494
"1221","25007",17275,3659,45.9,16581,16.6,45.4,2752,694,907,32.96,-0.19,1.6,0.884
"1222","25009",775860,123692,40.8,744961,14.3,40.4,106529,30899,17163,16.11,2.16,0.22,0.996
"1223","25011",70926,13785,45.9,71489,15.4,44.3,11009,-563,2776,25.22,0.08,0.97,0.614
"1224","25013",469188,73787,38.7,464072,14.3,38.8,66362,5116,7425,11.19,0.75,-0.18,0.192
"1225","25015",161197,24649,36.1,158850,12.8,36.2,20333,2347,4316,21.23,0.3,0.64,0.504
"1226","25017",1582857,228153,38.5,1507558,13.2,38.5,198998,75299,29155,14.65,3.9,0.1,1.62
"1227","25019",10912,1605,39.8,10194,12.1,38.8,1233,718,372,30.17,-0.27,1.37,0.714
"1228","25021",694389,110873,41,672078,14.6,40.6,98123,22311,12750,12.99,1.52,-0.04,0.584
"1229","25023",509114,84804,42.6,495407,14,41.1,69357,13707,15447,22.27,1.91,0.72,1.196
"1230","25025",780685,88307,32.6,724502,10.5,31.6,76073,56183,12234,16.08,1.45,0.22,0.712
"1231","25027",818249,118983,40.1,799277,12.9,39.2,103107,18972,15876,15.4,1.97,0.16,0.884
"1232","26001",10413,3652,57.9,10943,31.7,55.3,3469,-530,183,5.28,-0.3,-0.67,-0.522
"1233","26003",9254,2182,49.3,9531,21.2,47.5,2021,-277,161,7.97,-0.3,-0.45,-0.39
"1234","26005",114145,17311,39.7,111589,13.2,39,14730,2556,2581,17.52,0.05,0.33,0.218
"1235","26007",28730,6326,47.6,29602,19.7,45.8,5832,-872,494,8.47,-0.25,-0.41,-0.346
"1236","26009",23133,5938,50.4,23634,22.4,48,5294,-501,644,12.16,-0.23,-0.1,-0.152
"1237","26011",15238,3537,49.3,15952,20.6,46.7,3286,-714,251,7.64,-0.29,-0.48,-0.404
"1238","26013",8580,1712,43.4,8808,17.3,43.3,1524,-228,188,12.34,-0.3,-0.09,-0.174
"1239","26015",59607,10353,42.7,59249,14.7,41.3,8710,358,1643,18.86,-0.09,0.44,0.228
"1240","26017",105350,19757,42.9,107633,16.4,41.5,17652,-2283,2105,11.92,-0.02,-0.12,-0.08
"1241","26019",17462,4269,48.9,17554,21.1,46.4,3704,-92,565,15.25,-0.24,0.15,-0.00600000000000001
"1242","26021",154948,28504,42,156759,16.3,40.8,25552,-1811,2952,11.55,0.1,-0.15,-0.05
"1243","26023",43543,7492,41.2,44920,15,40,6738,-1377,754,11.19,-0.22,-0.18,-0.196
"1244","26025",134327,22244,39.9,136063,14.8,39.2,20137,-1736,2107,10.46,-0.02,-0.24,-0.152
"1245","26027",51397,9959,44.7,52412,16.5,42.5,8648,-1015,1311,15.16,-0.14,0.14,0.028
"1246","26029",26160,5815,47.7,26057,18.8,45.3,4899,103,916,18.7,-0.19,0.43,0.182
"1247","26031",25475,6439,50.1,26195,21.6,47.1,5658,-720,781,13.8,-0.21,0.03,-0.066
"1248","26033",38023,6342,39.7,38919,14.6,39.1,5682,-896,660,11.62,-0.23,-0.15,-0.182
"1249","26035",30597,6874,46.9,30924,20.1,45.5,6216,-327,658,10.59,-0.23,-0.23,-0.23
"1250","26037",77321,11987,40.4,75274,13.2,38.5,9936,2047,2051,20.64,-0.03,0.59,0.342
"1251","26039",13821,3316,50,14119,20.9,47.5,2951,-298,365,12.37,-0.27,-0.09,-0.162
"1252","26041",36395,8011,46.9,37075,19.2,45.5,7118,-680,893,12.55,-0.2,-0.07,-0.122
"1253","26043",25694,5418,46.4,26286,19.1,45.4,5021,-592,397,7.91,-0.27,-0.45,-0.378
"1254","26045",108586,18358,40.9,107861,14.1,40.4,15208,725,3150,20.71,0.13,0.6,0.412
"1255","26047",32978,6651,45,32799,16.9,43.1,5543,179,1108,19.99,-0.17,0.54,0.256
"1256","26049",410881,66191,40.1,425337,13.8,38.4,58697,-14456,7494,12.77,0.76,-0.05,0.274
"1257","26051",25324,6431,49.5,25736,22.8,47.5,5868,-412,563,9.59,-0.24,-0.32,-0.288
"1258","26053",15577,3762,48.7,16297,21.8,46.8,3553,-720,209,5.88,-0.3,-0.62,-0.492
"1259","26055",91222,16202,42.8,87483,15,40.8,13122,3739,3080,23.47,0.12,0.82,0.54
"1260","26057",41319,6734,39,42340,14.9,38.5,6309,-1021,425,6.74,-0.26,-0.55,-0.434
"1261","26059",45909,8244,42,46617,15.7,40.8,7319,-708,925,12.64,-0.19,-0.07,-0.118
"1262","26061",36333,5914,32.9,36519,15,33.1,5478,-186,436,7.96,-0.26,-0.45,-0.374
"1263","26063",31750,7565,48.5,33001,21.8,46.8,7194,-1251,371,5.16,-0.27,-0.68,-0.516
"1264","26065",286185,35475,31.7,281323,10.5,31.3,29539,4862,5936,20.1,0.53,0.55,0.542
"1265","26067",64147,8670,38.7,64149,11.4,36.5,7313,-2,1357,18.56,-0.13,0.42,0.2
"1266","26069",25317,7201,52.6,25880,26.1,51.1,6755,-563,446,6.6,-0.26,-0.56,-0.44
"1267","26071",11291,3262,53.8,11837,26.5,51.6,3137,-546,125,3.98,-0.31,-0.78,-0.592
"1268","26073",70572,8028,27.4,70186,9.7,25.3,6808,386,1220,17.92,-0.15,0.37,0.162
"1269","26075",158989,25827,41,160257,14.2,39.5,22756,-1268,3071,13.5,0.12,0,0.048
"1270","26077",259830,35923,34.1,250704,12.3,34,30837,9126,5086,16.49,0.41,0.25,0.314
"1271","26079",17358,3368,44.6,17231,16.8,43.2,2895,127,473,16.34,-0.26,0.24,0.04
"1272","26081",636376,79797,35,605244,11.2,34.3,67787,31132,12010,17.72,1.41,0.35,0.774
"1273","26083",2136,669,55.1,2168,25,51.8,542,-32,127,23.43,-0.31,0.82,0.368
"1274","26085",11669,3127,52.1,11543,23.9,50,2759,126,368,13.34,-0.27,-0.01,-0.114
"1275","26087",88205,14480,43.6,88626,13.4,41.6,11876,-421,2604,21.93,0.05,0.7,0.44
"1276","26089",21564,6023,53.3,21677,23.9,50.5,5181,-113,842,16.25,-0.2,0.23,0.058
"1277","26091",98585,17040,41.6,99878,14.7,40.2,14682,-1293,2358,16.06,0.02,0.21,0.134
"1278","26093",186946,28440,42.9,181678,12.1,40.9,21983,5268,6457,29.37,0.61,1.31,1.03
"1279","26095",6406,1315,44.2,6590,17.7,43.5,1166,-184,149,12.78,-0.3,-0.05,-0.15
"1280","26097",10836,2792,51.8,11144,22.7,49.1,2530,-308,262,10.36,-0.29,-0.25,-0.266
"1281","26099",864019,137311,41,841769,14.4,40,121215,22250,16096,13.28,2.01,-0.01,0.798
"1282","26101",24432,5826,48.7,24753,20.8,47.1,5149,-321,677,13.15,-0.23,-0.02,-0.104
"1283","26103",67145,11536,39.1,67178,14.8,39.5,9942,-33,1594,16.03,-0.09,0.21,0.09
"1284","26105",28800,6256,46,28672,19.2,45.1,5505,128,751,13.64,-0.22,0.02,-0.076
"1285","26107",43181,7485,36.4,42947,15.3,34.1,6571,234,914,13.91,-0.19,0.04,-0.052
"1286","26109",23389,5196,48,24041,19.3,46.2,4640,-652,556,11.98,-0.25,-0.12,-0.172
"1287","26111",83489,14137,41.5,83744,14.8,40.3,12394,-255,1743,14.06,-0.07,0.05,0.00199999999999999
"1288","26113",14982,2925,43.4,14945,17.4,41.9,2600,37,325,12.5,-0.28,-0.08,-0.16
"1289","26115",149619,24345,42.2,151944,13.5,40.3,20512,-2325,3833,18.69,0.23,0.43,0.35
"1290","26117",62956,10236,40.5,63357,14.2,39,8997,-401,1239,13.77,-0.15,0.03,-0.042
"1291","26119",9290,2793,55.3,9709,27.2,52.3,2641,-419,152,5.76,-0.3,-0.63,-0.498
"1292","26121",172707,26768,39.1,171755,13.7,38.5,23530,952,3238,13.76,0.14,0.03,0.074
"1293","26123",47899,8636,42.6,48517,15.6,40.7,7569,-618,1067,14.1,-0.17,0.05,-0.038
"1294","26125",1241860,192477,41,1207097,13.4,40.2,161751,34763,30726,19,4.12,0.46,1.924
"1295","26127",26317,5207,42.7,26636,17.1,42,4555,-319,652,14.31,-0.23,0.07,-0.05
"1296","26129",20979,5105,49.7,21674,22.2,47.5,4812,-695,293,6.09,-0.28,-0.6,-0.472
"1297","26131",6072,2022,57.1,6703,26.8,53.1,1796,-631,226,12.58,-0.29,-0.07,-0.158
"1298","26133",23221,4568,43.5,23486,17,41.7,3993,-265,575,14.4,-0.24,0.08,-0.048
"1299","26135",8304,2177,51.8,8709,23.9,49.8,2081,-405,96,4.61,-0.31,-0.72,-0.556
"1300","26137",24247,4778,44.9,24175,17,42.7,4110,72,668,16.25,-0.23,0.23,0.046
"1301","26139",280243,38532,34.9,264835,11.8,34.6,31251,15408,7281,23.3,0.73,0.81,0.778
"1302","26141",12854,3767,54.3,13368,26.5,51.6,3543,-514,224,6.32,-0.29,-0.58,-0.464
"1303","26143",23934,7301,55.3,24447,27.9,53.3,6821,-513,480,7.04,-0.26,-0.52,-0.416
"1304","26145",193803,34251,40.8,200017,15.3,39.6,30603,-6214,3648,11.92,0.2,-0.12,0.00800000000000002
"1305","26147",159761,27482,43.2,162978,14.6,41.3,23795,-3217,3687,15.49,0.21,0.17,0.186
"1306","26149",60890,10189,39.4,61314,14.9,38.6,9136,-424,1053,11.53,-0.17,-0.16,-0.164
"1307","26151",41535,8292,44.8,43096,17.7,42.7,7628,-1561,664,8.7,-0.23,-0.39,-0.326
"1308","26153",8114,2001,51.1,8455,21.5,48.3,1818,-341,183,10.07,-0.3,-0.28,-0.288
"1309","26155",68617,11608,42,70402,14.5,40.4,10208,-1785,1400,13.71,-0.12,0.02,-0.036
"1310","26157",53569,10085,44.1,55616,16.1,41.6,8954,-2047,1131,12.63,-0.16,-0.07,-0.106
"1311","26159",75190,12397,41.6,76149,14,40.1,10661,-959,1736,16.28,-0.07,0.23,0.11
"1312","26161",361509,45102,33.4,346010,10.3,33.1,35639,15499,9463,26.55,1.04,1.07,1.058
"1313","26163",1763822,253640,37.9,1822469,12.7,37.2,231454,-58647,22186,9.59,2.89,-0.32,0.964
"1314","26165",32915,5875,41.9,32694,15.9,40.8,5198,221,677,13.02,-0.23,-0.03,-0.11
"1315","27001",15841,4977,54.5,16166,27.6,51.8,4462,-325,515,11.54,-0.25,-0.16,-0.196
"1316","27003",344861,43117,38.2,331649,9.9,37.1,32833,13212,10284,31.32,1.16,1.46,1.34
"1317","27005",33552,6518,41.8,32600,17.5,42.6,5705,952,813,14.25,-0.21,0.07,-0.042
"1318","27007",45847,6724,33.4,44652,13.1,33.5,5849,1195,875,14.96,-0.2,0.12,-0.00800000000000002
"1319","27009",39360,5210,35.6,38560,12,34.1,4627,800,583,12.6,-0.24,-0.07,-0.138
"1320","27011",5039,1269,49,5250,25.8,48.7,1354,-211,-85,-6.28,-0.34,-1.62,-1.108
"1321","27013",65767,8451,30.6,63991,11.7,29.9,7487,1776,964,12.88,-0.19,-0.05,-0.106
"1322","27015",25243,5076,42.5,25772,19,43.1,4897,-529,179,3.66,-0.3,-0.8,-0.6
"1323","27017",35408,5835,40.7,35304,15.1,41,5331,104,504,9.45,-0.25,-0.33,-0.298
"1324","27019",98799,10302,37.2,91355,8.7,36.3,7948,7444,2354,29.62,0.02,1.33,0.806
"1325","27021",28810,6987,48.7,28519,21.3,47,6075,291,912,15.01,-0.19,0.13,0.00199999999999999
"1326","27023",12040,2446,43,12327,19.4,42.7,2391,-287,55,2.3,-0.32,-0.91,-0.674
"1327","27025",54297,7627,40.9,53526,11.6,38.6,6209,771,1418,22.84,-0.12,0.77,0.414
"1328","27027",62040,7875,32.6,58937,12.1,32.1,7131,3103,744,10.43,-0.22,-0.25,-0.238
"1329","27029",8824,1742,42.7,8672,18.7,42.3,1622,152,120,7.4,-0.31,-0.49,-0.418
"1330","27031",5270,1378,52.1,5206,20.6,49.8,1072,64,306,28.54,-0.28,1.24,0.632
"1331","27033",11437,2538,43.3,11665,21.7,43.6,2531,-228,7,0.28,-0.32,-1.08,-0.776
"1332","27035",63505,13321,44.1,62521,18.6,42.7,11629,984,1692,14.55,-0.08,0.09,0.022
"1333","27037",414655,52234,37.7,399443,10.1,36.8,40344,15212,11890,29.47,1.4,1.31,1.346
"1334","27039",20485,2804,38,20071,12.5,37,2509,414,295,11.76,-0.28,-0.14,-0.196
"1335","27041",36891,7967,44.3,36167,19.9,43.6,7197,724,770,10.7,-0.21,-0.22,-0.216
"1336","27043",13966,3114,46.8,14546,21.7,45.9,3156,-580,-42,-1.33,-0.33,-1.21,-0.858
"1337","27045",20825,4180,42.5,20880,19.2,42.9,4009,-55,171,4.27,-0.3,-0.75,-0.57
"1338","27047",30619,6643,44.3,31188,20.3,44.4,6331,-569,312,4.93,-0.28,-0.7,-0.532
"1339","27049",46138,8369,42.9,46144,16.5,41.9,7614,-6,755,9.92,-0.22,-0.29,-0.262
"1340","27051",5923,1366,45.3,6016,22.2,46.4,1336,-93,30,2.25,-0.32,-0.92,-0.68
"1341","27053",1224763,158332,36.3,1158039,11.4,35.9,132016,66724,26316,19.93,3.49,0.53,1.714
"1342","27055",18709,3734,45.4,19001,17.7,44,3363,-292,371,11.03,-0.27,-0.2,-0.228
"1343","27057",20743,4985,48.6,20372,21.2,47.1,4319,371,666,15.42,-0.23,0.16,0.00399999999999999
"1344","27059",38584,5593,39.5,38004,12.6,37.9,4789,580,804,16.79,-0.21,0.27,0.078
"1345","27061",45237,9683,45.9,45052,19.1,45.2,8605,185,1078,12.53,-0.17,-0.07,-0.11
"1346","27063",10104,2066,44,10273,20.1,44.4,2065,-169,1,0.05,-0.33,-1.1,-0.792
"1347","27065",15948,3080,44.5,16255,16.7,42.1,2715,-307,365,13.44,-0.27,0,-0.108
"1348","27067",42577,7448,39.5,42150,16.3,39.8,6870,427,578,8.41,-0.24,-0.41,-0.342
"1349","27069",4384,1027,47.9,4547,22.9,47.8,1041,-163,-14,-1.34,-0.33,-1.21,-0.858
"1350","27071",12776,2839,48.6,13293,19.9,46.2,2645,-517,194,7.33,-0.3,-0.5,-0.42
"1351","27073",6840,1736,50,7240,23.8,49.1,1723,-400,13,0.75,-0.32,-1.04,-0.752
"1352","27075",10578,2584,50.3,10849,22.7,48.4,2463,-271,121,4.91,-0.31,-0.7,-0.544
"1353","27077",3841,846,51.1,4039,20.2,48.5,816,-198,30,3.68,-0.32,-0.8,-0.608
"1354","27079",27810,4588,41.4,27744,14.7,40.2,4078,66,510,12.51,-0.25,-0.08,-0.148
"1355","27081",5724,1401,45.9,5876,24.7,46.5,1451,-152,-50,-3.45,-0.33,-1.38,-0.96
"1356","27083",25789,3801,35.6,25714,13.6,34.4,3497,75,304,8.69,-0.28,-0.39,-0.346
"1357","27085",35816,6351,40.4,36527,15.4,39.1,5625,-711,726,12.91,-0.22,-0.04,-0.112
"1358","27087",5500,933,35.7,5442,16.2,37.2,882,58,51,5.78,-0.32,-0.63,-0.506
"1359","27089",9397,1893,43.4,9475,19.2,44.2,1819,-78,74,4.07,-0.31,-0.77,-0.586
"1360","27091",20084,4462,45.2,20727,20.9,45.6,4332,-643,130,3,-0.31,-0.86,-0.64
"1361","27093",23105,4255,42.2,23262,16.6,41.4,3861,-157,394,10.2,-0.27,-0.27,-0.27
"1362","27095",25635,4487,40.1,26004,16.1,39.5,4187,-369,300,7.17,-0.28,-0.51,-0.418
"1363","27097",32880,5923,41.7,33173,16.1,40.6,5341,-293,582,10.9,-0.24,-0.21,-0.222
"1364","27099",39386,7194,39.3,39115,17.4,38.6,6806,271,388,5.7,-0.27,-0.63,-0.486
"1365","27101",8394,2063,48.1,8690,22.7,47,1973,-296,90,4.56,-0.31,-0.73,-0.562
"1366","27103",33477,4933,36.3,32689,12.2,33.3,3988,788,945,23.7,-0.19,0.84,0.428
"1367","27105",21854,3382,36,21349,16.2,36.7,3459,505,-77,-2.23,-0.34,-1.28,-0.904
"1368","27107",6589,1404,44.3,6796,21.2,45.1,1441,-207,-37,-2.57,-0.33,-1.31,-0.918
"1369","27109",151685,21498,37.1,144507,12.6,36.3,18208,7178,3290,18.07,0.15,0.38,0.288
"1370","27111",57790,12979,46.6,57381,21,46,12050,409,929,7.71,-0.19,-0.47,-0.358
"1371","27113",14197,2448,39.5,13950,15.7,39.5,2190,247,258,11.78,-0.29,-0.14,-0.2
"1372","27115",29057,5489,44.5,29564,16.4,42.4,4848,-507,641,13.22,-0.23,-0.02,-0.104
"1373","27117",9229,1883,42.4,9536,20,42.6,1907,-307,-24,-1.26,-0.33,-1.2,-0.852
"1374","27119",31564,5500,38.7,31426,16.7,40.3,5248,138,252,4.8,-0.29,-0.71,-0.542
"1375","27121",10932,2505,45.9,10978,21.5,45.8,2360,-46,145,6.14,-0.3,-0.6,-0.48
"1376","27123",537893,71903,34.8,510885,12.1,34.6,61817,27008,10086,16.32,1.13,0.24,0.596
"1377","27125",4017,764,42.2,4100,17.3,41.6,709,-83,55,7.76,-0.32,-0.47,-0.41
"1378","27127",15430,3229,43.5,16006,20,42.6,3201,-576,28,0.87,-0.32,-1.03,-0.746
"1379","27129",14798,2979,44.4,15653,19.3,43.9,3021,-855,-42,-1.39,-0.33,-1.22,-0.864
"1380","27131",65251,9407,36.6,64171,12.5,34.9,8021,1080,1386,17.28,-0.12,0.31,0.138
"1381","27133",9433,1836,40.9,9620,19.1,41.4,1837,-187,-1,-0.05,-0.33,-1.11,-0.798
"1382","27135",15537,2447,41.4,15665,14.2,40.3,2224,-128,223,10.03,-0.29,-0.28,-0.284
"1383","27137",200294,35541,41,200150,16,40.8,32024,144,3517,10.98,0.18,-0.2,-0.048
"1384","27139",141463,13567,36,130689,7.8,34.9,10194,10774,3373,33.09,0.16,1.61,1.03
"1385","27141",92024,9482,35.9,88558,8.4,34.3,7439,3466,2043,27.46,-0.03,1.15,0.678
"1386","27143",14888,2605,41.6,15189,16.3,40.6,2476,-301,129,5.21,-0.31,-0.67,-0.526
"1387","27145",155300,21391,34.1,150307,12.1,33.4,18187,4993,3204,17.62,0.14,0.34,0.26
"1388","27147",36612,5941,39.3,36524,14.7,38.8,5369,88,572,10.65,-0.24,-0.23,-0.234
"1389","27149",9759,1675,33.1,9712,16.5,34.3,1602,47,73,4.56,-0.32,-0.73,-0.566
"1390","27151",9448,2017,44.1,9764,20.2,44.4,1972,-316,45,2.28,-0.32,-0.91,-0.674
"1391","27153",24423,4924,43.7,24783,17.5,41.9,4337,-360,587,13.53,-0.24,0.01,-0.09
"1392","27155",3357,853,48.6,3549,26.3,47.6,933,-192,-80,-8.57,-0.34,-1.8,-1.216
"1393","27157",21490,4322,45,21636,17.2,43,3721,-146,601,16.15,-0.24,0.22,0.036
"1394","27159",13626,2871,41.7,13808,20.9,43.4,2886,-182,-15,-0.52,-0.33,-1.14,-0.816
"1395","27161",18898,3108,39.6,19089,14.7,39.3,2806,-191,302,10.76,-0.28,-0.22,-0.244
"1396","27163",250979,33303,39.2,238721,10.7,38.2,25543,12258,7760,30.38,0.8,1.39,1.154
"1397","27165",10936,2119,39.9,11177,18.8,40.4,2101,-241,18,0.86,-0.32,-1.03,-0.746
"1398","27167",6398,1177,44.3,6584,17.5,42.8,1152,-186,25,2.17,-0.32,-0.92,-0.68
"1399","27169",50992,7889,34.5,51481,13.5,33.1,6950,-489,939,13.51,-0.19,0.01,-0.07
"1400","27171",131130,15019,36.2,124737,9.7,34.6,12099,6393,2920,24.13,0.1,0.88,0.568
"1401","27173",9930,1954,42.6,10357,19.6,42.7,2030,-427,-76,-3.74,-0.34,-1.41,-0.982
"1402","28001",31583,5454,40.3,32391,16,40.4,5183,-808,271,5.23,-0.29,-0.67,-0.518
"1403","28003",37242,6505,40.1,37027,15.9,39.4,5887,215,618,10.5,-0.24,-0.24,-0.24
"1404","28005",12574,2699,46.4,13139,18.3,44.3,2404,-565,295,12.27,-0.28,-0.1,-0.172
"1405","28007",18731,3437,39.9,19454,17.2,39.9,3346,-723,91,2.72,-0.31,-0.88,-0.652
"1406","28009",8306,1441,42,8725,16.1,40.2,1405,-419,36,2.56,-0.32,-0.89,-0.662
"1407","28011",33121,4692,35,34239,12.2,34.2,4177,-1118,515,12.33,-0.25,-0.09,-0.154
"1408","28013",14617,2580,40.5,14903,16.6,39.3,2474,-286,106,4.28,-0.31,-0.75,-0.574
"1409","28015",10221,2191,46,10553,17.7,42.3,1868,-332,323,17.29,-0.28,0.32,0.08
"1410","28017",17305,2746,37,17458,14.7,38.4,2566,-153,180,7.01,-0.3,-0.53,-0.438
"1411","28019",8360,1709,44.3,8506,17.8,42.4,1514,-146,195,12.88,-0.3,-0.05,-0.15
"1412","28021",9106,1442,33.8,9681,12.4,31.7,1200,-575,242,20.17,-0.29,0.55,0.214
"1413","28023",16089,3063,41.8,16688,16.5,40.8,2754,-599,309,11.22,-0.28,-0.18,-0.22
"1414","28025",19990,3381,39.4,20633,14.6,38.8,3012,-643,369,12.25,-0.27,-0.1,-0.168
"1415","28027",24296,3327,34,26099,12.3,32.8,3210,-1803,117,3.64,-0.31,-0.8,-0.604
"1416","28029",28748,4575,38.2,29324,13.7,36.4,4017,-576,558,13.89,-0.24,0.04,-0.072
"1417","28031",19172,3052,37.5,19571,15.2,37.2,2975,-399,77,2.59,-0.31,-0.89,-0.658
"1418","28033",173267,20972,36.6,161536,10.3,35.1,16638,11731,4334,26.05,0.3,1.03,0.738
"1419","28035",75835,9661,32,75378,11.6,31.1,8744,457,917,10.49,-0.19,-0.24,-0.22
"1420","28037",7772,1420,42.5,8055,16.4,41.4,1321,-283,99,7.49,-0.31,-0.49,-0.418
"1421","28039",23545,3345,36.5,22579,13,36.3,2935,966,410,13.97,-0.27,0.04,-0.084
"1422","28041",13801,1732,39,14352,11.5,36.3,1650,-551,82,4.97,-0.31,-0.69,-0.538
"1423","28043",21379,3589,40.3,21886,15.1,39.3,3305,-507,284,8.59,-0.28,-0.4,-0.352
"1424","28045",46277,8591,43.2,44044,15.3,40.5,6739,2233,1852,27.48,-0.06,1.15,0.666
"1425","28047",200491,27293,35.9,188110,11.9,35.4,22385,12381,4908,21.93,0.39,0.7,0.576
"1426","28049",243249,30758,34.2,246335,10.9,33,26851,-3086,3907,14.55,0.24,0.09,0.15
"1427","28051",18267,2516,34.5,19207,12.9,32.2,2478,-940,38,1.53,-0.32,-0.98,-0.716
"1428","28053",8678,1298,36.4,9399,12.9,35.1,1212,-721,86,7.1,-0.31,-0.52,-0.436
"1429","28055",1296,224,38.8,1556,15.2,40.2,237,-260,-13,-5.49,-0.33,-1.55,-1.062
"1430","28057",23439,3913,39.8,23362,16,39.1,3738,77,175,4.68,-0.3,-0.72,-0.552
"1431","28059",141314,20482,38.3,139430,12.5,37,17429,1884,3053,17.52,0.12,0.33,0.246
"1432","28061",16547,3090,40.8,17033,16.1,41.2,2742,-486,348,12.69,-0.28,-0.06,-0.148
"1433","28063",7463,1084,34.9,7743,13.1,38.6,1014,-280,70,6.9,-0.32,-0.54,-0.452
"1434","28065",11639,2357,43.6,12364,17,41.4,2102,-725,255,12.13,-0.29,-0.11,-0.182
"1435","28067",68328,10700,37.1,67868,14.4,36.8,9773,460,927,9.49,-0.19,-0.32,-0.268
"1436","28069",10082,1845,41.7,10391,15.6,37.4,1621,-309,224,13.82,-0.29,0.03,-0.098
"1437","28071",52744,5896,29.3,47586,10.2,27.3,4854,5158,1042,21.47,-0.17,0.66,0.328
"1438","28073",60517,7424,34.7,55580,10.8,33.1,6003,4937,1421,23.67,-0.12,0.84,0.456
"1439","28075",78221,12264,37.7,80204,14.1,36.9,11309,-1983,955,8.44,-0.19,-0.41,-0.322
"1440","28077",12659,2125,40.4,12832,15,40.1,1925,-173,200,10.39,-0.3,-0.25,-0.27
"1441","28079",22936,3333,35.8,23563,13.2,32.7,3110,-627,223,7.17,-0.29,-0.51,-0.422
"1442","28081",84840,11823,37,83235,13,35.9,10821,1605,1002,9.26,-0.18,-0.34,-0.276
"1443","28083",30113,3935,33.1,32196,11.9,32.5,3831,-2083,104,2.71,-0.31,-0.88,-0.652
"1444","28085",34542,5479,37.8,34850,14.2,37.5,4949,-308,530,10.71,-0.25,-0.22,-0.232
"1445","28087",59558,8635,36.6,59584,13,36.2,7746,-26,889,11.48,-0.2,-0.16,-0.176
"1446","28089",102212,12370,37,95481,10.7,36.1,10216,6731,2154,21.08,-0.01,0.63,0.374
"1447","28091",25466,4283,39.9,26810,14.9,37.8,3995,-1344,288,7.21,-0.28,-0.51,-0.418
"1448","28093",35981,5633,39.9,37019,12.8,38.5,4738,-1038,895,18.89,-0.2,0.45,0.19
"1449","28095",35967,6607,41,36912,15.9,39.2,5869,-945,738,12.57,-0.22,-0.07,-0.13
"1450","28097",10309,2041,42.6,10866,17.3,41.1,1880,-557,161,8.56,-0.3,-0.4,-0.36
"1451","28099",29437,4484,36.7,29682,13.5,35.3,4007,-245,477,11.9,-0.26,-0.13,-0.182
"1452","28101",21437,3394,37.2,21687,15.1,37.8,3275,-250,119,3.63,-0.31,-0.8,-0.604
"1453","28103",10942,1662,36,11511,13.7,36.5,1577,-569,85,5.39,-0.31,-0.66,-0.52
"1454","28105",49392,5081,25.4,47486,9.4,25.2,4464,1906,617,13.82,-0.24,0.03,-0.078
"1455","28107",34229,4981,37,34675,12.9,36,4473,-446,508,11.36,-0.25,-0.17,-0.202
"1456","28109",55049,9706,41,55886,14.7,39.2,8215,-837,1491,18.15,-0.11,0.39,0.19
"1457","28111",12047,2049,40.7,12217,15.1,39.4,1845,-170,204,11.06,-0.3,-0.2,-0.24
"1458","28113",39763,6317,37,40300,14.2,37.1,5723,-537,594,10.38,-0.24,-0.25,-0.246
"1459","28115",31075,4395,36.8,29962,13.2,36,3955,1113,440,11.13,-0.26,-0.19,-0.218
"1460","28117",25389,4390,39.5,25384,15.8,38.7,4011,5,379,9.45,-0.27,-0.33,-0.306
"1461","28119",7537,1171,37.9,8171,14.2,38.5,1160,-634,11,0.95,-0.32,-1.02,-0.74
"1462","28121",149645,20879,37.2,142136,11.6,36.2,16488,7509,4391,26.63,0.31,1.08,0.772
"1463","28123",28399,4061,36.5,28207,12.6,35,3554,192,507,14.27,-0.25,0.07,-0.058
"1464","28125",4631,752,39.6,4835,14.2,38.2,687,-204,65,9.46,-0.32,-0.33,-0.326
"1465","28127",27215,4409,38.9,27476,14.1,38.1,3874,-261,535,13.81,-0.25,0.03,-0.082
"1466","28129",16114,2867,40.1,16425,15.6,39.2,2562,-311,305,11.9,-0.28,-0.13,-0.19
"1467","28131",17981,2524,37.4,17657,12.2,35.5,2154,324,370,17.18,-0.27,0.31,0.078
"1468","28133",26915,3210,34.9,29230,10.4,33.4,3040,-2315,170,5.59,-0.3,-0.64,-0.504
"1469","28135",14552,2019,34.7,15262,12.1,35.4,1847,-710,172,9.31,-0.3,-0.34,-0.324
"1470","28137",28333,4299,37.7,28580,12.7,36.2,3630,-247,669,18.43,-0.23,0.41,0.154
"1471","28139",21993,3506,38.6,22095,14.6,38.1,3226,-102,280,8.68,-0.29,-0.39,-0.35
"1472","28141",19476,3871,42.6,19573,18.1,42.5,3543,-97,328,9.26,-0.28,-0.34,-0.316
"1473","28143",10276,1103,32.9,10716,9.5,32.2,1018,-440,85,8.35,-0.31,-0.42,-0.376
"1474","28145",28202,4507,37.9,27175,14.5,37.1,3940,1027,567,14.39,-0.24,0.08,-0.048
"1475","28147",14670,2671,40.3,15405,15.9,36.8,2449,-735,222,9.06,-0.29,-0.36,-0.332
"1476","28149",47510,7179,38.2,48419,13.2,37.9,6391,-909,788,12.33,-0.21,-0.09,-0.138
"1477","28151",48002,6750,36.7,51010,12.4,35.2,6325,-3008,425,6.72,-0.26,-0.55,-0.434
"1478","28153",20458,3274,37.4,20754,14,37.5,2906,-296,368,12.66,-0.27,-0.06,-0.144
"1479","28155",9868,1682,39.9,10162,15.1,40.5,1534,-294,148,9.65,-0.3,-0.31,-0.306
"1480","28157",9084,1448,37.3,9778,14,36.2,1369,-694,79,5.77,-0.31,-0.63,-0.502
"1481","28159",18482,3490,42,19160,16.6,39.4,3181,-678,309,9.71,-0.28,-0.31,-0.298
"1482","28161",12426,2321,41.8,12647,17,40.2,2150,-221,171,7.95,-0.3,-0.45,-0.39
"1483","28163",27496,3563,35.7,28220,11.9,35.4,3358,-724,205,6.1,-0.3,-0.6,-0.48
"1484","29001",25437,3559,27.3,25542,12.9,29.1,3295,-105,264,8.01,-0.29,-0.44,-0.38
"1485","29003",17358,3088,42.5,17205,16.1,41.9,2770,153,318,11.48,-0.28,-0.16,-0.208
"1486","29005",5335,1314,47.8,5664,21.9,46.1,1240,-329,74,5.97,-0.31,-0.61,-0.49
"1487","29007",25763,4349,39.6,25617,15.9,38.6,4073,146,276,6.78,-0.29,-0.55,-0.446
"1488","29009",35398,6856,43.2,35680,18.1,41.8,6458,-282,398,6.16,-0.27,-0.6,-0.468
"1489","29011",11942,2259,40.6,12428,17.6,40.5,2187,-486,72,3.29,-0.32,-0.83,-0.626
"1490","29013",16405,3104,41.6,17003,17.7,41.5,3010,-598,94,3.12,-0.31,-0.85,-0.634
"1491","29015",18918,5482,53.2,19021,25.9,51.5,4926,-103,556,11.29,-0.25,-0.18,-0.208
"1492","29017",12347,2317,43.9,12389,16.7,42.5,2069,-42,248,11.99,-0.29,-0.12,-0.188
"1493","29019",174589,19080,30.6,163266,9.3,29.6,15184,11323,3896,25.66,0.24,1,0.696
"1494","29021",89425,13345,37.1,89162,13.9,36.6,12394,263,951,7.67,-0.19,-0.47,-0.358
"1495","29023",42826,7683,40.3,42792,16.7,40.6,7146,34,537,7.51,-0.25,-0.49,-0.394
"1496","29025",9046,1752,42.9,9302,17,41.7,1581,-256,171,10.82,-0.3,-0.21,-0.246
"1497","29027",44793,6686,38.3,44157,12.2,37.6,5387,636,1299,24.11,-0.14,0.87,0.466
"1498","29029",44855,11856,51,43731,21.7,48.7,9490,1124,2366,24.93,0.02,0.94,0.572
"1499","29031",78013,12224,36.3,75690,14.3,36.3,10824,2323,1400,12.93,-0.12,-0.04,-0.072
"1500","29033",8909,1816,42.8,9279,19,41.8,1763,-370,53,3.01,-0.32,-0.85,-0.638
"1501","29035",6255,1174,41.3,6225,16.6,40.3,1033,30,141,13.65,-0.31,0.02,-0.112
"1502","29037",101888,15952,39.5,99394,13.7,38.3,13617,2494,2335,17.15,0.01,0.3,0.184
"1503","29039",13862,3170,44,13941,21.9,44.6,3053,-79,117,3.83,-0.31,-0.79,-0.598
"1504","29041",7586,1759,45.7,7759,21.5,45.3,1668,-173,91,5.46,-0.31,-0.65,-0.514
"1505","29043",83028,12067,37.6,77474,12.5,36.7,9684,5554,2383,24.61,0.02,0.92,0.56
"1506","29045",6807,1352,43.8,7082,17.9,43.1,1268,-275,84,6.62,-0.31,-0.56,-0.46
"1507","29047",236068,31148,36.8,222048,11.4,36.4,25313,14020,5835,23.05,0.52,0.79,0.682
"1508","29049",20495,3545,41.1,20687,15.7,40.6,3248,-192,297,9.14,-0.28,-0.35,-0.322
"1509","29051",76749,11319,38.2,75813,12.6,37.8,9552,936,1767,18.5,-0.07,0.41,0.218
"1510","29053",17620,2953,39.2,17542,15.1,37.6,2649,78,304,11.48,-0.28,-0.16,-0.208
"1511","29055",24387,4444,41.6,24753,16.3,40.2,4035,-366,409,10.14,-0.27,-0.27,-0.27
"1512","29057",7581,1717,46.7,7811,20.2,46.3,1578,-230,139,8.81,-0.31,-0.38,-0.352
"1513","29059",16441,3184,43.5,16825,16.9,41.7,2843,-384,341,11.99,-0.28,-0.12,-0.184
"1514","29061",8300,1643,41.3,8341,17.3,40.3,1443,-41,200,13.86,-0.3,0.03,-0.102
"1515","29063",12564,2014,40.5,12878,14.1,40.2,1816,-314,198,10.9,-0.3,-0.21,-0.246
"1516","29065",15566,3243,44.1,15595,18.9,42.9,2947,-29,296,10.04,-0.28,-0.28,-0.28
"1517","29067",13391,3050,47.3,13690,20,44.9,2738,-299,312,11.4,-0.28,-0.17,-0.214
"1518","29069",30905,5436,39.4,31970,16.6,39.5,5307,-1065,129,2.43,-0.31,-0.9,-0.664
"1519","29071",102413,16325,40.7,101440,13.9,39.4,14100,973,2225,15.78,0,0.19,0.114
"1520","29073",14769,3193,45.9,15160,20,45.1,3032,-391,161,5.31,-0.3,-0.67,-0.522
"1521","29075",6688,1297,41.3,6773,20.5,42.1,1388,-85,-91,-6.56,-0.34,-1.64,-1.12
"1522","29077",286759,44397,35.7,275671,14.1,35.6,38870,11088,5527,14.22,0.47,0.06,0.224
"1523","29079",10111,2114,40.9,10256,20.6,41.8,2113,-145,1,0.05,-0.33,-1.1,-0.792
"1524","29081",8615,1851,42.8,8901,21,42.6,1869,-286,-18,-0.96,-0.33,-1.18,-0.84
"1525","29083",21834,4493,44,22234,19.6,43.9,4358,-400,135,3.1,-0.31,-0.85,-0.634
"1526","29085",9352,3097,54.8,9554,29.6,52.7,2828,-202,269,9.51,-0.29,-0.32,-0.308
"1527","29087",4499,1054,48.4,4840,21.5,46.1,1041,-341,13,1.25,-0.32,-1,-0.728
"1528","29089",10144,1745,38.9,10160,15.9,39.7,1615,-16,130,8.05,-0.31,-0.44,-0.388
"1529","29091",40139,7573,40.2,40330,17.2,39.6,6937,-191,636,9.17,-0.23,-0.35,-0.302
"1530","29093",10286,2130,45.3,10563,17.7,42.8,1870,-277,260,13.9,-0.29,0.04,-0.092
"1531","29095",688554,96070,36.6,672784,12.5,36.2,84098,15770,11972,14.24,1.41,0.07,0.606
"1532","29097",118522,17144,35.9,116493,13.2,35.1,15377,2029,1767,11.49,-0.07,-0.16,-0.124
"1533","29099",222639,30227,38.8,218628,11.3,37.7,24705,4011,5522,22.35,0.47,0.73,0.626
"1534","29101",53941,6348,29.9,52964,10.7,29.7,5667,977,681,12.02,-0.23,-0.12,-0.164
"1535","29103",3976,841,43.7,4111,19.9,43.9,818,-135,23,2.81,-0.32,-0.87,-0.65
"1536","29105",35488,6050,40.1,35507,15.6,39.1,5539,-19,511,9.23,-0.25,-0.35,-0.31
"1537","29107",32655,5869,42.2,33278,16.3,40.3,5424,-623,445,8.2,-0.26,-0.43,-0.362
"1538","29109",38131,6653,39.7,38559,16.2,39.3,6247,-428,406,6.5,-0.27,-0.57,-0.45
"1539","29111",10078,1818,40.1,10203,16.4,38.7,1673,-125,145,8.67,-0.3,-0.39,-0.354
"1540","29113",54800,6920,37.3,52637,11,35.6,5790,2163,1130,19.52,-0.16,0.5,0.236
"1541","29115",12248,2472,42.5,12668,19.2,43,2432,-420,40,1.64,-0.32,-0.97,-0.71
"1542","29117",15025,2956,40.7,15068,18.6,41.5,2803,-43,153,5.46,-0.3,-0.65,-0.51
"1543","29119",22753,3349,38.3,22970,12.6,36.5,2894,-217,455,15.72,-0.26,0.19,0.00999999999999998
"1544","29121",15319,3266,43,15532,19.8,42.1,3075,-213,191,6.21,-0.3,-0.59,-0.474
"1545","29123",12226,2220,41.7,12334,18.1,41.2,2232,-108,-12,-0.54,-0.33,-1.15,-0.822
"1546","29125",8959,1798,44.4,9140,18,43.1,1645,-181,153,9.3,-0.3,-0.34,-0.324
"1547","29127",28703,4881,39.2,28703,15.9,39.3,4564,0,317,6.95,-0.28,-0.53,-0.43
"1548","29129",3669,742,43.6,3763,20.5,43.7,771,-94,-29,-3.76,-0.33,-1.41,-0.978
"1549","29131",24947,4415,41.1,24822,16.3,40.3,4046,125,369,9.12,-0.27,-0.35,-0.318
"1550","29133",13916,2322,39.4,14231,15.3,39.8,2177,-315,145,6.66,-0.3,-0.56,-0.456
"1551","29135",15904,2468,38.6,15587,13.7,37.4,2135,317,333,15.6,-0.28,0.18,-0.00400000000000002
"1552","29137",8676,1851,45.2,8876,19,44,1686,-200,165,9.79,-0.3,-0.3,-0.3
"1553","29139",11618,2304,43.9,12181,18.4,42.9,2241,-563,63,2.81,-0.32,-0.87,-0.65
"1554","29141",20097,4672,46.4,20479,22.2,47,4546,-382,126,2.77,-0.31,-0.87,-0.646
"1555","29143",18030,3214,41.3,18780,16.2,39.7,3042,-750,172,5.65,-0.3,-0.64,-0.504
"1556","29145",58237,10015,39.4,58314,15.7,39.1,9155,-77,860,9.39,-0.2,-0.33,-0.278
"1557","29147",22744,3225,29,23305,13.2,28.1,3076,-561,149,4.84,-0.3,-0.7,-0.54
"1558","29149",10779,2470,46.3,10885,19.7,45.1,2144,-106,326,15.21,-0.28,0.14,-0.028
"1559","29151",13610,2240,40.1,13857,15.1,39.2,2092,-247,148,7.07,-0.3,-0.52,-0.432
"1560","29153",9328,2441,51.1,9672,23.8,49.5,2302,-344,139,6.04,-0.31,-0.61,-0.49
"1561","29155",17344,2738,37.7,18288,14.8,36.9,2707,-944,31,1.15,-0.32,-1.01,-0.734
"1562","29157",19135,3245,40.5,18986,15.8,39.5,3000,149,245,8.17,-0.29,-0.43,-0.374
"1563","29159",42309,6617,37.9,42044,14.8,37.3,6223,265,394,6.33,-0.27,-0.58,-0.456
"1564","29161",44873,6870,34.8,44825,14.2,34,6365,48,505,7.93,-0.25,-0.45,-0.37
"1565","29163",18517,3124,39.2,18574,15.5,39.8,2879,-57,245,8.51,-0.29,-0.4,-0.356
"1566","29165",96899,13069,38.2,89567,11.3,38.5,10121,7332,2948,29.13,0.1,1.29,0.814
"1567","29167",31347,5497,37.5,31035,16.5,38.1,5121,312,376,7.34,-0.27,-0.5,-0.408
"1568","29169",53132,4261,27.6,51620,7.3,26.6,3768,1512,493,13.08,-0.25,-0.03,-0.118
"1569","29171",4846,1135,46.7,4976,21.7,45.2,1080,-130,55,5.09,-0.32,-0.68,-0.536
"1570","29173",10208,2024,44.7,10198,17,44.2,1734,10,290,16.72,-0.28,0.27,0.05
"1571","29175",24987,3914,39.2,25388,14.3,37.9,3630,-401,284,7.82,-0.28,-0.46,-0.388
"1572","29177",22859,3933,41.8,23422,15,40,3513,-563,420,11.96,-0.26,-0.12,-0.176
"1573","29179",6361,1377,46,6682,20.6,44.8,1376,-321,1,0.07,-0.33,-1.1,-0.792
"1574","29181",13807,2682,42.5,14070,18.6,41.9,2617,-263,65,2.48,-0.32,-0.9,-0.668
"1575","29183",385115,52938,38,360695,11.4,37,41119,24420,11819,28.74,1.39,1.25,1.306
"1576","29185",9396,2482,50,9693,23.6,48.6,2288,-297,194,8.48,-0.3,-0.41,-0.366
"1577","29186",17882,3211,43,18066,16.1,42.6,2909,-184,302,10.38,-0.28,-0.25,-0.262
"1578","29187",66248,10248,39.2,65246,14.4,38.7,9395,1002,853,9.08,-0.2,-0.36,-0.296
"1579","29189",999539,168620,40.3,999147,15.1,39.8,150871,392,17749,11.76,2.24,-0.14,0.812
"1580","29195",23010,4097,37.9,23232,16.1,38,3740,-222,357,9.55,-0.27,-0.32,-0.3
"1581","29197",4450,865,40.6,4397,19.6,41.4,862,53,3,0.35,-0.33,-1.07,-0.774
"1582","29199",4883,906,37.2,4843,18.1,39.4,877,40,29,3.31,-0.32,-0.83,-0.626
"1583","29201",38858,6635,40,39192,15.1,38.9,5918,-334,717,12.12,-0.22,-0.11,-0.154
"1584","29203",8273,1690,44.8,8407,17.6,44.2,1480,-134,210,14.19,-0.3,0.06,-0.084
"1585","29205",6084,1227,41.9,6328,19.6,43.4,1240,-244,-13,-1.05,-0.33,-1.19,-0.846
"1586","29207",29634,5722,42.1,29902,18,41.4,5382,-268,340,6.32,-0.28,-0.58,-0.46
"1587","29209",31529,9133,52.7,31968,24.1,49.7,7704,-439,1429,18.55,-0.12,0.42,0.204
"1588","29211",6382,1252,41.5,6667,17.3,40.2,1153,-285,99,8.59,-0.31,-0.4,-0.364
"1589","29213",54308,10996,41.9,51596,18,41.1,9287,2712,1709,18.4,-0.08,0.41,0.214
"1590","29215",25714,5042,42.3,25840,18,41.9,4651,-126,391,8.41,-0.27,-0.41,-0.354
"1591","29217",20665,3677,40.7,20958,16.2,40.3,3395,-293,282,8.31,-0.28,-0.42,-0.364
"1592","29219",33554,5772,40.9,32440,15.1,39.7,4898,1114,874,17.84,-0.2,0.36,0.136
"1593","29221",24968,3887,40.6,25120,13.6,40.1,3416,-152,471,13.79,-0.26,0.03,-0.086
"1594","29223",13369,2985,46.9,13444,21.3,45.9,2864,-75,121,4.22,-0.31,-0.76,-0.58
"1595","29225",37558,5608,37.4,36183,13.3,37.6,4812,1375,796,16.54,-0.21,0.25,0.066
"1596","29227",2053,493,47.5,2146,23.4,47.5,502,-93,-9,-1.79,-0.33,-1.25,-0.882
"1597","29229",18304,3461,42,18732,17.3,40.6,3241,-428,220,6.79,-0.29,-0.54,-0.44
"1598","29510",314867,38129,35.2,318527,11.1,34,35356,-3660,2773,7.84,0.08,-0.46,-0.244
"1599","30001",9360,1964,43,9228,17,44,1569,132,395,25.18,-0.27,0.96,0.468
"1600","30003",13290,1522,29.9,12872,10.4,30.1,1339,418,183,13.67,-0.3,0.02,-0.108
"1601","30005",6646,976,34,6514,13.8,35,899,132,77,8.57,-0.31,-0.4,-0.364
"1602","30007",5755,1274,46.3,5575,18.1,45.6,1009,180,265,26.26,-0.29,1.05,0.514
"1603","30009",10466,2479,50,10057,19.3,48,1941,409,538,27.72,-0.25,1.17,0.602
"1604","30011",1320,346,51.6,1276,25.5,51.5,325,44,21,6.46,-0.32,-0.57,-0.47
"1605","30013",81816,14237,38.4,81248,15.7,38.7,12756,568,1481,11.61,-0.11,-0.15,-0.134
"1606","30015",5812,1089,40.9,5811,17.4,41.5,1011,1,78,7.72,-0.31,-0.47,-0.406
"1607","30017",11895,2213,41,11706,17.4,41.7,2037,189,176,8.64,-0.3,-0.39,-0.354
"1608","30019",1788,423,45.5,1734,27,51.7,468,54,-45,-9.62,-0.33,-1.89,-1.266
"1609","30021",9324,1616,41.9,9022,17.8,42.1,1606,302,10,0.62,-0.32,-1.05,-0.758
"1610","30023",9131,1980,47.4,9277,18.9,46.2,1753,-146,227,12.95,-0.29,-0.04,-0.14
"1611","30025",2925,471,38.1,3051,16.9,40.8,516,-126,-45,-8.72,-0.33,-1.82,-1.224
"1612","30027",11327,2547,45.7,11507,22,48.1,2532,-180,15,0.59,-0.32,-1.05,-0.758
"1613","30029",96147,16861,42.3,90967,14.4,41.2,13099,5180,3762,28.72,0.22,1.25,0.838
"1614","30031",100733,11471,33.4,90339,9.5,32.4,8582,10394,2889,33.66,0.09,1.66,1.032
"1615","30033",1086,226,43.8,1100,26,48,286,-14,-60,-20.98,-0.33,-2.82,-1.824
"1616","30035",13677,1541,31,13422,10.6,31.4,1423,255,118,8.29,-0.31,-0.42,-0.376
"1617","30037",747,168,54,769,23,50.2,177,-22,-9,-5.08,-0.33,-1.52,-1.044
"1618","30039",3206,882,53.1,3083,25.2,51.8,777,123,105,13.51,-0.31,0.01,-0.118
"1619","30041",16468,2276,34.4,16157,12.8,35.2,2068,311,208,10.06,-0.3,-0.28,-0.288
"1620","30043",11625,2221,47.9,11360,14.5,46.8,1647,265,574,34.85,-0.24,1.75,0.954
"1621","30045",1965,451,51.7,2052,23.9,51.3,490,-87,-39,-7.96,-0.33,-1.75,-1.182
"1622","30047",29518,5969,41.8,28794,17.1,41,4924,724,1045,21.22,-0.17,0.64,0.316
"1623","30049",66290,11034,41.1,63432,13.9,40.7,8817,2858,2217,25.14,0,0.96,0.576
"1624","30051",2245,504,48.4,2326,23.1,47.6,537,-81,-33,-6.15,-0.33,-1.61,-1.098
"1625","30053",19249,5003,52.1,19594,20.7,49.2,4056,-345,947,23.35,-0.19,0.81,0.41
"1626","30055",1728,423,49.1,1808,17.2,47.1,311,-80,112,36.01,-0.31,1.85,0.986
"1627","30057",7902,2158,53,7688,21.1,50,1622,214,536,33.05,-0.25,1.61,0.866
"1628","30059",2000,455,43.9,1900,19.1,46.9,363,100,92,25.34,-0.31,0.97,0.458
"1629","30061",4194,1122,52.1,4203,22.5,49.6,946,-9,176,18.6,-0.3,0.42,0.132
"1630","30063",114231,16074,35.4,109402,11.5,34.3,12581,4829,3493,27.76,0.18,1.17,0.774
"1631","30065",4766,1091,49.1,4597,18.7,48.2,860,169,231,26.86,-0.29,1.1,0.544
"1632","30067",16001,3230,46.4,15655,17.1,45.9,2677,346,553,20.66,-0.25,0.59,0.254
"1633","30069",453,100,51.7,566,18.2,47.6,103,-113,-3,-2.91,-0.33,-1.34,-0.936
"1634","30071",4139,876,46.4,4203,20.7,48.4,870,-64,6,0.69,-0.32,-1.04,-0.752
"1635","30073",6081,1185,40.5,6147,19.1,42.9,1174,-66,11,0.94,-0.32,-1.02,-0.74
"1636","30075",1610,364,51.4,1639,22.1,47.4,362,-29,2,0.55,-0.33,-1.06,-0.768
"1637","30077",6852,1304,45.6,7067,16.4,45.4,1159,-215,145,12.51,-0.3,-0.08,-0.168
"1638","30079",1325,350,51,1193,29.2,56.3,348,132,2,0.57,-0.33,-1.05,-0.762
"1639","30081",41387,9699,48.5,40311,19.5,46.3,7861,1076,1838,23.38,-0.06,0.81,0.462
"1640","30083",11405,1541,38,9961,14.4,40.5,1434,1444,107,7.46,-0.31,-0.49,-0.418
"1641","30085",11218,1169,30.2,10477,11.3,30.9,1184,741,-15,-1.27,-0.33,-1.21,-0.858
"1642","30087",9292,1336,36.5,9261,11.5,37.3,1065,31,271,25.45,-0.29,0.98,0.472
"1643","30089",11414,3133,52.7,11421,21.8,49.9,2490,-7,643,25.82,-0.23,1.01,0.514
"1644","30091",3568,781,46.9,3447,22,48.2,758,121,23,3.03,-0.32,-0.85,-0.638
"1645","30093",34514,6034,39.9,34164,16.3,41.7,5569,350,465,8.35,-0.26,-0.42,-0.356
"1646","30095",9342,1889,46.5,9096,16.9,46,1537,246,352,22.9,-0.27,0.77,0.354
"1647","30097",3646,961,50.1,3661,17.1,43.1,626,-15,335,53.51,-0.28,3.28,1.856
"1648","30099",6040,1331,44.5,6082,20.8,45.6,1265,-42,66,5.22,-0.32,-0.67,-0.53
"1649","30101",5031,794,41.9,5210,14.3,42.8,745,-179,49,6.58,-0.32,-0.56,-0.464
"1650","30103",790,165,49.2,698,24.9,51.9,174,92,-9,-5.17,-0.33,-1.52,-1.044
"1651","30105",7561,1607,44.4,7423,20.8,45.8,1544,138,63,4.08,-0.32,-0.77,-0.59
"1652","30107",2108,401,39.4,2142,24.8,48.5,531,-34,-130,-24.48,-0.34,-3.11,-2.002
"1653","30109",1121,288,49.4,899,24.9,50.2,224,222,64,28.57,-0.32,1.24,0.616
"1654","30111",156332,24533,38.3,148191,14.1,38.5,20895,8141,3638,17.41,0.2,0.33,0.278
"1655","31001",31564,5313,37.9,31299,15.4,37.8,4820,265,493,10.23,-0.25,-0.26,-0.256
"1656","31003",6406,1443,45.9,6655,21,46.5,1398,-249,45,3.22,-0.32,-0.84,-0.632
"1657","31005",421,92,43.3,490,15.7,37.4,77,-69,15,19.48,-0.32,0.49,0.166
"1658","31007",728,125,48.1,778,12.6,45.2,98,-50,27,27.55,-0.32,1.16,0.568
"1659","31009",502,121,46.8,584,14.9,41.3,87,-82,34,39.08,-0.32,2.1,1.132
"1660","31011",5357,1167,45,5473,21.2,45.7,1160,-116,7,0.6,-0.32,-1.05,-0.758
"1661","31013",11200,1879,40.5,11345,15,40.5,1702,-145,177,10.4,-0.3,-0.25,-0.27
"1662","31015",2049,546,52.1,2025,26.3,50.8,533,24,13,2.44,-0.32,-0.9,-0.668
"1663","31017",3058,789,48.9,3183,23.4,46.7,745,-125,44,5.91,-0.32,-0.62,-0.5
"1664","31019",48834,6454,32.9,46330,12.2,32.3,5652,2504,802,14.19,-0.21,0.06,-0.048
"1665","31021",6546,1555,46.6,6829,23,47.2,1571,-283,-16,-1.02,-0.33,-1.18,-0.84
"1666","31023",8105,1615,43.5,8345,19.3,44.4,1611,-240,4,0.25,-0.33,-1.08,-0.78
"1667","31025",25513,4094,41.9,25214,14.3,40.9,3606,299,488,13.53,-0.25,0.01,-0.094
"1668","31027",8561,1791,44.1,8807,20.5,44.5,1805,-246,-14,-0.78,-0.33,-1.17,-0.834
"1669","31029",3803,797,44.4,3964,20.9,43.7,828,-161,-31,-3.74,-0.33,-1.41,-0.978
"1670","31031",5792,1240,43.8,5722,21.2,47.1,1213,70,27,2.23,-0.32,-0.92,-0.68
"1671","31033",10012,1740,40.7,10038,15.9,40.3,1596,-26,144,9.02,-0.3,-0.36,-0.336
"1672","31035",6264,1211,43.5,6497,17.8,43.8,1156,-233,55,4.76,-0.32,-0.71,-0.554
"1673","31037",10616,1326,33.7,10453,13.9,34.4,1453,163,-127,-8.74,-0.34,-1.82,-1.228
"1674","31039",9039,1929,44,9140,20.9,43.4,1910,-101,19,0.99,-0.32,-1.02,-0.74
"1675","31041",10836,2315,43.5,10904,20.8,44.7,2268,-68,47,2.07,-0.32,-0.93,-0.686
"1676","31043",20529,2671,33.8,20869,11.2,32.8,2337,-340,334,14.29,-0.28,0.07,-0.07
"1677","31045",8972,1571,34,9176,16.5,34.9,1514,-204,57,3.76,-0.32,-0.79,-0.602
"1678","31047",23925,3522,35.8,24267,14,36.5,3397,-342,125,3.68,-0.31,-0.8,-0.604
"1679","31049",1901,473,46.1,1962,24.2,49.1,475,-61,-2,-0.42,-0.33,-1.14,-0.816
"1680","31051",5765,1117,42.2,5982,18.1,41,1083,-217,34,3.14,-0.32,-0.84,-0.632
"1681","31053",36576,6820,39.1,36590,18.3,40.2,6696,-14,124,1.85,-0.31,-0.95,-0.694
"1682","31055",549706,65645,34.3,518271,10.7,33.6,55455,31435,10190,18.38,1.15,0.4,0.7
"1683","31057",2017,433,43.6,1996,21.7,47.4,433,21,0,0,-0.33,-1.1,-0.792
"1684","31059",5603,1298,47.5,5867,22.5,45.9,1320,-264,-22,-1.67,-0.33,-1.24,-0.876
"1685","31061",3019,797,50.7,3196,24.7,48.8,789,-177,8,1.01,-0.32,-1.02,-0.74
"1686","31063",2624,633,45.5,2693,19,44.8,512,-69,121,23.63,-0.31,0.83,0.374
"1687","31065",4814,1127,46.1,4922,23,47.1,1132,-108,-5,-0.44,-0.33,-1.14,-0.816
"1688","31067",21632,4403,44.2,22209,19.4,43.6,4309,-577,94,2.18,-0.31,-0.92,-0.676
"1689","31069",1913,494,51.7,2011,28,51.4,563,-98,-69,-12.26,-0.34,-2.11,-1.402
"1690","31071",1958,538,51.4,2106,26.1,49.1,550,-148,-12,-2.18,-0.33,-1.28,-0.9
"1691","31073",2019,461,49.5,2020,20.4,45.4,412,-1,49,11.89,-0.32,-0.13,-0.206
"1692","31075",682,159,48.6,608,20.4,47.3,124,74,35,28.23,-0.32,1.21,0.598
"1693","31077",2436,602,45.9,2515,23.2,46.1,583,-79,19,3.26,-0.32,-0.83,-0.626
"1694","31079",61233,8625,35.8,58681,13.2,35.6,7746,2552,879,11.35,-0.2,-0.17,-0.182
"1695","31081",9149,1673,42.3,9096,16.9,42.9,1537,53,136,8.85,-0.31,-0.38,-0.352
"1696","31083",3469,896,49.5,3419,23.7,49.9,810,50,86,10.62,-0.31,-0.23,-0.262
"1697","31085",957,170,42.7,1037,22.4,45.5,232,-80,-62,-26.72,-0.33,-3.29,-2.106
"1698","31087",2860,695,47.1,2898,22.8,49.1,661,-38,34,5.14,-0.32,-0.68,-0.536
"1699","31089",10293,2168,44.1,10418,20.6,45.9,2146,-125,22,1.03,-0.32,-1.02,-0.74
"1700","31091",684,245,58,689,26.3,47.8,181,-5,64,35.36,-0.32,1.8,0.952
"1701","31093",6385,1327,43.3,6294,18.8,43.2,1183,91,144,12.17,-0.3,-0.1,-0.18
"1702","31095",7276,1691,45.7,7572,22.1,47,1673,-296,18,1.08,-0.32,-1.01,-0.734
"1703","31097",5200,951,41.1,5188,17.5,43.7,908,12,43,4.74,-0.32,-0.71,-0.554
"1704","31099",6547,1222,40.6,6514,18,41.9,1173,33,49,4.18,-0.32,-0.76,-0.584
"1705","31101",8129,2107,49.7,8284,22,48.2,1822,-155,285,15.64,-0.28,0.18,-0.00400000000000002
"1706","31103",720,179,50.2,742,29.1,53.7,216,-22,-37,-17.13,-0.33,-2.5,-1.632
"1707","31105",3688,895,46,3789,24.2,46.8,917,-101,-22,-2.4,-0.33,-1.3,-0.912
"1708","31107",8496,2021,47.2,8648,23,46.6,1989,-152,32,1.61,-0.32,-0.97,-0.71
"1709","31109",306357,38694,33.2,286425,10.9,32.6,31220,19932,7474,23.94,0.76,0.86,0.82
"1710","31111",35569,6288,40.4,36212,15.7,38.7,5685,-643,603,10.61,-0.24,-0.23,-0.234
"1711","31113",919,178,38.9,724,24.6,50.5,178,195,0,0,-0.33,-1.1,-0.792
"1712","31115",537,139,52.8,534,20.2,47.5,108,3,31,28.7,-0.32,1.25,0.622
"1713","31117",432,78,48.5,348,26.4,49,92,84,-14,-15.22,-0.33,-2.35,-1.542
"1714","31119",35062,5346,36.9,34766,14.9,37.2,5180,296,166,3.2,-0.3,-0.84,-0.624
"1715","31121",7829,1576,43.5,7779,18.6,43.3,1447,50,129,8.91,-0.31,-0.37,-0.346
"1716","31123",4903,965,42.9,4993,19.5,43.1,974,-90,-9,-0.92,-0.33,-1.18,-0.84
"1717","31125",3569,722,45.4,3730,19.2,44.9,716,-161,6,0.84,-0.32,-1.03,-0.746
"1718","31127",7041,1334,38,7224,17.7,41.5,1279,-183,55,4.3,-0.32,-0.75,-0.578
"1719","31129",4318,1151,49.4,4490,26,49.3,1167,-172,-16,-1.37,-0.33,-1.21,-0.858
"1720","31131",15875,3000,41.7,15729,18.9,42.7,2973,146,27,0.91,-0.32,-1.03,-0.746
"1721","31133",2704,733,50.1,2753,26.3,49.3,724,-49,9,1.24,-0.32,-1,-0.728
"1722","31135",2904,644,43.3,2947,20.5,45.1,604,-43,40,6.62,-0.32,-0.56,-0.464
"1723","31137",9163,1803,42.1,9184,19.3,43.9,1773,-21,30,1.69,-0.32,-0.96,-0.704
"1724","31139",7175,1333,41.7,7231,17.7,41.9,1280,-56,53,4.14,-0.32,-0.76,-0.584
"1725","31141",32875,5360,38.3,32195,14.6,38.7,4700,680,660,14.04,-0.23,0.05,-0.062
"1726","31143",5244,1074,45.5,5371,19.9,45.1,1069,-127,5,0.47,-0.32,-1.06,-0.764
"1727","31145",10870,2089,40.8,11013,18.6,42.4,2048,-143,41,2,-0.32,-0.94,-0.692
"1728","31147",8045,1861,47.6,8355,22.6,47.7,1888,-310,-27,-1.43,-0.33,-1.22,-0.864
"1729","31149",1381,380,51.9,1540,22.9,49.4,353,-159,27,7.65,-0.32,-0.47,-0.41
"1730","31151",14325,2016,36,14278,14.7,36,2099,47,-83,-3.95,-0.34,-1.42,-0.988
"1731","31153",175188,18488,34.2,159413,8.6,33,13710,15775,4778,34.85,0.37,1.75,1.198
"1732","31155",20953,3651,41,20696,15.7,41.9,3249,257,402,12.37,-0.27,-0.09,-0.162
"1733","31157",36509,6532,39.5,36835,16.7,38.7,6151,-326,381,6.19,-0.27,-0.59,-0.462
"1734","31159",17045,2848,38.3,16729,15.3,38.3,2560,316,288,11.25,-0.28,-0.18,-0.22
"1735","31161",5241,1334,46.1,5432,22.7,46.6,1233,-191,101,8.19,-0.31,-0.43,-0.382
"1736","31163",3048,772,49.3,3133,24.3,48.6,761,-85,11,1.45,-0.32,-0.98,-0.716
"1737","31165",1256,288,51.6,1262,21.7,47.5,274,-6,14,5.11,-0.32,-0.68,-0.536
"1738","31167",6020,963,41,6139,14.5,39,890,-119,73,8.2,-0.32,-0.43,-0.386
"1739","31169",5133,1309,48.2,5195,25.6,48.8,1330,-62,-21,-1.58,-0.33,-1.23,-0.87
"1740","31171",643,133,42.1,831,15.8,38.9,131,-188,2,1.53,-0.33,-0.98,-0.72
"1741","31173",7055,846,28.1,6926,11.9,28.6,824,129,22,2.67,-0.32,-0.88,-0.656
"1742","31175",4252,1050,46,4322,23.9,47.3,1033,-70,17,1.65,-0.32,-0.97,-0.71
"1743","31177",20414,3387,41.2,20201,14.2,41,2869,213,518,18.06,-0.25,0.38,0.128
"1744","31179",9409,1384,31.7,9542,13.6,29.4,1298,-133,86,6.63,-0.31,-0.56,-0.46
"1745","31181",3597,812,46.1,3773,23.8,47.5,898,-176,-86,-9.58,-0.34,-1.89,-1.27
"1746","31183",846,217,50.2,725,19.2,47.3,139,121,78,56.12,-0.31,3.5,1.976
"1747","31185",13832,2649,40.9,13727,18.1,42.2,2485,105,164,6.6,-0.3,-0.56,-0.456
"1748","32001",24022,4249,38.9,24779,15.7,39.2,3890,-757,359,9.23,-0.27,-0.35,-0.318
"1749","32003",2112436,289329,36.9,1954773,11.5,35.5,224799,157663,64530,28.71,9.02,1.25,4.358
"1750","32005",47632,12095,50.8,47056,20.6,47.3,9694,576,2401,24.77,0.02,0.93,0.566
"1751","32007",52377,5191,34.1,49133,8.5,33.4,4176,3244,1015,24.31,-0.18,0.89,0.462
"1752","32009",1102,310,48,916,27.4,51.8,251,186,59,23.51,-0.32,0.82,0.364
"1753","32011",1728,249,47.3,1809,15.9,38.5,288,-81,-39,-13.54,-0.33,-2.21,-1.458
"1754","32013",17088,1981,35.6,16511,9.6,36.6,1585,577,396,24.98,-0.27,0.95,0.462
"1755","32015",5887,913,37.8,5751,11,35.4,633,136,280,44.23,-0.29,2.52,1.396
"1756","32017",5203,1124,41.6,5282,18.4,35.9,972,-79,152,15.64,-0.3,0.18,-0.012
"1757","32019",52303,10551,43.8,51797,16.3,40.6,8443,506,2108,24.97,-0.02,0.94,0.556
"1758","32021",4471,960,46.7,4718,23,50.4,1085,-247,-125,-11.52,-0.34,-2.05,-1.366
"1759","32023",43296,12266,51.6,43801,23.9,48.8,10468,-505,1798,17.18,-0.07,0.31,0.158
"1760","32027",6661,1004,43.1,6707,12.9,39.9,865,-46,139,16.07,-0.31,0.22,0.00800000000000001
"1761","32029",3891,1238,54.7,4010,17.7,52.8,710,-119,528,74.37,-0.25,4.99,2.894
"1762","32031",445551,66809,38,422010,12.3,37,51907,23541,14902,28.71,1.83,1.25,1.482
"1763","32033",9858,1562,39.4,9967,14.8,42,1475,-109,87,5.9,-0.31,-0.62,-0.496
"1764","32510",54219,10499,43,55184,16.7,41.6,9216,-965,1283,13.92,-0.14,0.04,-0.032
"1765","33001",60383,12266,46.7,60206,16.8,44.5,10115,177,2151,21.27,-0.01,0.64,0.38
"1766","33003",47524,12022,51.4,47761,20.8,48.2,9934,-237,2088,21.02,-0.02,0.62,0.364
"1767","33005",76109,13705,42.5,77106,14.9,41.1,11489,-997,2216,19.29,0,0.48,0.288
"1768","33007",32119,7034,48,32872,19.5,46.6,6410,-753,624,9.73,-0.24,-0.3,-0.276
"1769","33009",89280,16752,42.9,88985,15.6,41.2,13882,295,2870,20.67,0.09,0.59,0.39
"1770","33011",406371,58520,40.5,401101,12,39.2,48132,5270,10388,21.58,1.18,0.67,0.874
"1771","33013",147958,24542,42.8,146742,13.8,41.5,20250,1216,4292,21.2,0.3,0.64,0.504
"1772","33015",302479,48446,44.1,295872,12.8,42.3,37872,6607,10574,27.92,1.21,1.19,1.198
"1773","33017",126552,17596,37,123295,12,36.7,14795,3257,2801,18.93,0.08,0.45,0.302
"1774","33019",43073,8410,46.1,43534,16.6,44.2,7227,-461,1183,16.37,-0.15,0.24,0.084
"1775","34001",272926,44540,41.1,274402,14.3,40.1,39239,-1476,5301,13.51,0.44,0.01,0.182
"1776","34003",937920,153527,41.6,906781,15.2,41.2,137831,31139,15696,11.39,1.95,-0.17,0.678
"1777","34005",449192,71468,41.4,449117,14,40.3,62876,75,8592,13.66,0.92,0.02,0.38
"1778","34007",510996,74496,38.5,513660,12.9,37.7,66262,-2664,8234,12.43,0.87,-0.08,0.3
"1779","34009",94549,23124,48.7,96987,21.8,47.3,21143,-2438,1981,9.37,-0.04,-0.33,-0.214
"1780","34011",154952,22010,36.8,156864,12.7,36.8,19922,-1912,2088,10.48,-0.02,-0.24,-0.152
"1781","34013",800401,102794,37.3,783840,11.6,36.3,90925,16561,11869,13.05,1.39,-0.03,0.538
"1782","34015",291372,42145,39.9,288187,12.5,38.7,36023,3185,6122,16.99,0.56,0.29,0.398
"1783","34017",679756,75984,34.9,636194,10.5,34.2,66800,43562,9184,13.75,1,0.03,0.418
"1784","34019",125717,20782,45.9,127996,13,43.4,16639,-2279,4143,24.9,0.27,0.94,0.672
"1785","34021",373362,52772,38.6,366442,12.8,37.8,46905,6920,5867,12.51,0.52,-0.08,0.16
"1786","34023",837288,115701,38.1,811064,12.4,37.2,100572,26224,15129,15.04,1.87,0.13,0.826
"1787","34025",627551,101128,42.8,629263,13.9,41.4,87468,-1712,13660,15.62,1.65,0.18,0.768
"1788","34027",498847,79042,42.3,493472,13.9,41.2,68593,5375,10449,15.23,1.19,0.15,0.566
"1789","34029",589699,130257,42.9,575961,21.1,42.7,121528,13738,8729,7.18,0.94,-0.51,0.07
"1790","34031",510563,69429,36.7,500168,12.2,36.2,61020,10395,8409,13.78,0.89,0.03,0.374
"1791","34033",63776,11000,41.9,66007,15.2,40.9,10033,-2231,967,9.64,-0.19,-0.31,-0.262
"1792","34035",333316,47955,41.3,323650,12.6,40.2,40780,9666,7175,17.59,0.71,0.34,0.488
"1793","34037",143570,22167,44.1,148962,12,41.8,17875,-5392,4292,24.01,0.3,0.87,0.642
"1794","34039",557320,75962,38.3,536383,12.7,37.9,68121,20937,7841,11.51,0.81,-0.16,0.228
"1795","34041",107088,17716,43.5,108488,14,41.4,15188,-1400,2528,16.64,0.04,0.26,0.172
"1796","35001",674855,99112,37.1,661924,12.4,36,82079,12931,17033,20.75,2.14,0.6,1.216
"1797","35003",3547,1389,60.2,3686,29.7,57.6,1095,-139,294,26.85,-0.28,1.1,0.548
"1798","35005",65454,9893,35.3,65343,14.1,34.8,9213,111,680,7.38,-0.23,-0.5,-0.392
"1799","35006",27049,3982,36.4,27293,12.9,37.2,3521,-244,461,13.09,-0.26,-0.03,-0.122
"1800","35007",12522,3109,48.8,13614,20.1,46.3,2736,-1092,373,13.63,-0.27,0.02,-0.096
"1801","35009",50283,5862,30.8,48101,11.6,31.6,5580,2182,282,5.05,-0.28,-0.69,-0.526
"1802","35011",2016,377,42.6,2069,20.3,47,420,-53,-43,-10.24,-0.33,-1.94,-1.296
"1803","35013",213849,30758,32.9,208794,12.5,32.4,26099,5055,4659,17.85,0.35,0.36,0.356
"1804","35015",56793,8024,35.9,53693,14.1,37,7571,3100,453,5.98,-0.26,-0.61,-0.47
"1805","35017",28382,7023,45.9,29602,21.7,45.8,6424,-1220,599,9.32,-0.24,-0.34,-0.3
"1806","35019",4426,1045,41.7,4655,16,40.1,745,-229,300,40.27,-0.28,2.2,1.208
"1807","35021",546,170,58.4,612,20.8,53.8,127,-66,43,33.86,-0.32,1.67,0.874
"1808","35023",4446,905,42.6,4903,17,40.2,834,-457,71,8.51,-0.32,-0.4,-0.368
"1809","35025",69505,7519,31.7,64670,11,31.6,7114,4835,405,5.69,-0.27,-0.64,-0.492
"1810","35027",19497,5236,50.9,20440,22.3,49.2,4558,-943,678,14.87,-0.23,0.12,-0.02
"1811","35028",18031,3099,43,18008,14.6,44,2629,23,470,17.88,-0.26,0.36,0.112
"1812","35029",24319,4950,39,25162,19.3,38.4,4856,-843,94,1.94,-0.31,-0.94,-0.688
"1813","35031",72849,8076,31.6,71888,9.5,30.3,6829,961,1247,18.26,-0.15,0.39,0.174
"1814","35033",4605,997,47,4830,21,46.3,1014,-225,-17,-1.68,-0.33,-1.24,-0.876
"1815","35035",65130,10656,35.6,64176,14.9,36.1,9562,954,1094,11.44,-0.17,-0.16,-0.164
"1816","35037",8447,2024,46.1,8956,21.4,45.5,1917,-509,107,5.58,-0.31,-0.64,-0.508
"1817","35039",39455,6850,40.7,40201,14.3,39.1,5749,-746,1101,19.15,-0.17,0.47,0.214
"1818","35041",19313,2508,29.7,19840,12,29.9,2381,-527,127,5.33,-0.31,-0.66,-0.52
"1819","35043",138815,21796,39.6,131302,12.4,38.1,16281,7513,5515,33.87,0.47,1.67,1.19
"1820","35045",128221,16841,34.6,128600,11,32.8,14146,-379,2695,19.05,0.06,0.46,0.3
"1821","35047",28203,5384,42.9,29225,15.4,41.4,4501,-1022,883,19.62,-0.2,0.51,0.226
"1822","35049",147514,30703,45.3,144209,15.5,43,22352,3305,8351,37.36,0.88,1.96,1.528
"1823","35051",11254,3880,55.9,11956,30.1,53.8,3599,-702,281,7.81,-0.28,-0.46,-0.388
"1824","35053",17098,3021,40,17843,14.1,35.8,2516,-745,505,20.07,-0.25,0.54,0.224
"1825","35055",32809,7593,47.7,32775,17.6,45.4,5768,34,1825,31.64,-0.06,1.49,0.87
"1826","35057",15534,2981,44,16285,14.5,40.8,2361,-751,620,26.26,-0.24,1.05,0.534
"1827","35059",4216,801,40.2,4460,18.3,40.5,816,-244,-15,-1.84,-0.33,-1.25,-0.882
"1828","35061",75845,12118,39,76172,13.1,37.4,9979,-327,2139,21.44,-0.02,0.66,0.388
"1829","36001",308580,48135,37.8,304511,14.1,38.2,42936,4069,5199,12.11,0.43,-0.11,0.106
"1830","36003",47400,8229,38.6,48837,15.3,37.8,7472,-1437,757,10.13,-0.22,-0.27,-0.25
"1831","36005",1455846,171277,33.6,1386364,10.6,32.7,146955,69482,24322,16.55,3.2,0.25,1.43
"1832","36007",196124,35094,39.6,199928,16.5,40.2,32988,-3804,2106,6.38,-0.02,-0.58,-0.356
"1833","36009",78175,13811,41.7,80166,15.5,40.8,12426,-1991,1385,11.15,-0.13,-0.19,-0.166
"1834","36011",78319,13610,42.5,79996,15.5,41.6,12399,-1677,1211,9.77,-0.15,-0.3,-0.24
"1835","36013",130846,24230,42.3,134599,16.7,40.6,22478,-3753,1752,7.79,-0.07,-0.46,-0.304
"1836","36015",86883,14998,41.2,88779,15.6,40.9,13850,-1896,1148,8.29,-0.16,-0.42,-0.316
"1837","36017",48763,9347,44.4,50490,16.8,42.9,8482,-1727,865,10.2,-0.2,-0.27,-0.242
"1838","36019",81224,12534,39.4,82054,13.4,39.1,10995,-830,1539,14,-0.1,0.05,-0.01
"1839","36021",61481,13273,47.4,62881,18.2,45.3,11444,-1400,1829,15.98,-0.06,0.21,0.102
"1840","36023",48334,7459,36.2,49453,13.3,35.8,6577,-1119,882,13.41,-0.2,0,-0.08
"1841","36025",45950,10464,47,47851,19.6,45.3,9379,-1901,1085,11.57,-0.17,-0.15,-0.158
"1842","36027",295685,47422,41.8,297291,13.7,40.2,40729,-1606,6693,16.43,0.64,0.24,0.4
"1843","36029",923995,155817,40.3,919542,15.8,40.3,145288,4453,10529,7.25,1.2,-0.51,0.174
"1844","36031",38233,8176,46.7,39309,18.4,44.6,7233,-1076,943,13.04,-0.19,-0.03,-0.094
"1845","36033",51054,7909,40.5,51698,13.4,39.3,6928,-644,981,14.16,-0.18,0.06,-0.036
"1846","36035",53955,9802,43.4,55358,16.1,41.7,8913,-1403,889,9.97,-0.2,-0.28,-0.248
"1847","36037",58537,10301,43.2,59992,15.7,41.6,9419,-1455,882,9.36,-0.2,-0.33,-0.278
"1848","36039",47791,9702,45.6,49122,17.7,44,8695,-1331,1007,11.58,-0.18,-0.15,-0.162
"1849","36041",4646,1282,53.7,4835,23.3,51,1127,-189,155,13.75,-0.3,0.03,-0.102
"1850","36043",62943,11947,43.7,64475,17.1,42.3,11025,-1532,922,8.36,-0.19,-0.42,-0.328
"1851","36045",116567,14245,31.9,117011,11.2,32.3,13105,-444,1140,8.7,-0.16,-0.39,-0.298
"1852","36047",2635121,337741,34.8,2512740,11.6,34.1,291478,122381,46263,15.87,6.37,0.2,2.668
"1853","36049",26845,4475,41.8,27062,15.3,40.3,4140,-217,335,8.09,-0.28,-0.44,-0.376
"1854","36051",64373,10387,40.4,65215,14,39.7,9130,-842,1257,13.77,-0.14,0.03,-0.038
"1855","36053",71760,11723,41.3,72977,14.2,39.3,10363,-1217,1360,13.12,-0.13,-0.03,-0.07
"1856","36055",748680,118667,38.6,744746,14.1,38.4,105009,3934,13658,13.01,1.65,-0.04,0.636
"1857","36057",49500,8852,41.1,50025,16.7,40.9,8354,-525,498,5.96,-0.25,-0.61,-0.466
"1858","36059",1363069,228558,41.5,1338712,15.4,41.2,206162,24357,22396,10.86,2.92,-0.21,1.042
"1859","36061",1653877,252718,37.1,1596735,13.5,36.4,215559,57142,37159,17.24,5.06,0.31,2.21
"1860","36063",212675,37617,43,215869,16,41.8,34539,-3194,3078,8.91,0.12,-0.37,-0.174
"1861","36065",232324,41019,41,234336,16.3,40.9,38197,-2012,2822,7.39,0.08,-0.5,-0.268
"1862","36067",467669,73551,38.8,466179,14.1,38.7,65731,1490,7820,11.9,0.81,-0.13,0.246
"1863","36069",109491,19926,43.4,107728,15.5,42.3,16698,1763,3228,19.33,0.14,0.48,0.344
"1864","36071",378174,49012,36.9,372951,11.1,36.7,41398,5223,7614,18.39,0.78,0.41,0.558
"1865","36073",41584,6845,42.8,42995,14.3,40.9,6148,-1411,697,11.34,-0.22,-0.17,-0.19
"1866","36075",119833,17685,39.8,122055,12.7,38.6,15501,-2222,2184,14.09,-0.01,0.05,0.026
"1867","36077",60750,11702,42,62147,16.7,40.4,10379,-1397,1323,12.75,-0.13,-0.06,-0.088
"1868","36079",99464,15514,43.8,99702,12.5,41.7,12463,-238,3051,24.48,0.12,0.9,0.588
"1869","36081",2339280,334838,38.3,2235008,12.9,37.3,288316,104272,46522,16.14,6.41,0.22,2.696
"1870","36083",159800,24956,39.9,159464,13.7,39.6,21847,336,3109,14.23,0.12,0.06,0.084
"1871","36085",475948,71694,39.9,468374,12.9,38.6,60420,7574,11274,18.66,1.31,0.43,0.782
"1872","36087",325027,49088,36.2,312011,13.6,36.8,42433,13016,6655,15.68,0.64,0.18,0.364
"1873","36089",110817,17477,38,112060,13.9,37.2,15576,-1243,1901,12.2,-0.05,-0.1,-0.08
"1874","36091",226632,37371,42.3,219832,13.8,40.8,30337,6800,7034,23.19,0.69,0.8,0.756
"1875","36093",155239,25120,39.8,154466,15,40,23170,773,1950,8.42,-0.04,-0.41,-0.262
"1876","36095",31611,6137,44.1,32617,16.1,42.4,5251,-1006,886,16.87,-0.2,0.28,0.088
"1877","36097",18112,3508,45.7,18472,17.2,44.3,3177,-360,331,10.42,-0.28,-0.25,-0.262
"1878","36099",34843,6158,42.2,35306,15.6,41.2,5508,-463,650,11.8,-0.23,-0.13,-0.17
"1879","36101",97539,17489,42.4,98992,15.9,41.3,15740,-1453,1749,11.11,-0.07,-0.19,-0.142
"1880","36103",1497595,233897,41,1492360,13.7,39.8,204453,5235,29444,14.4,3.94,0.08,1.624
"1881","36105",75783,13236,42.6,77340,14.9,41.8,11524,-1557,1712,14.86,-0.08,0.12,0.04
"1882","36107",49322,9139,44,51067,15.9,42.8,8120,-1745,1019,12.55,-0.18,-0.07,-0.114
"1883","36109",104415,13290,30.4,101570,10.9,29.8,11071,2845,2219,20.04,0,0.54,0.324
"1884","36111",180129,32421,43.6,182516,15,42.1,27377,-2387,5044,18.42,0.4,0.41,0.406
"1885","36113",64701,13127,46.2,65700,17.3,44.2,11366,-999,1761,15.49,-0.07,0.17,0.074
"1886","36115",62183,11034,43.6,63108,15.6,42.2,9845,-925,1189,12.08,-0.15,-0.11,-0.126
"1887","36117",91442,15725,43.6,93476,14.5,41.8,13554,-2034,2171,16.02,-0.01,0.21,0.122
"1888","36119",975321,156260,40.6,950227,14.7,40.1,139683,25094,16577,11.87,2.07,-0.13,0.75
"1889","36121",40886,6567,41.8,42092,14,40.7,5893,-1206,674,11.44,-0.23,-0.16,-0.188
"1890","36123",25083,4763,41.7,25351,16.6,40.4,4208,-268,555,13.19,-0.25,-0.02,-0.112
"1891","37001",157844,25600,39.7,151170,14.8,38.5,22373,6674,3227,14.42,0.14,0.08,0.104
"1892","37003",37159,6973,42.8,37014,15.6,41.1,5774,145,1199,20.77,-0.15,0.6,0.3
"1893","37005",10935,2732,49.2,11069,21.4,46,2369,-134,363,15.32,-0.27,0.15,-0.018
"1894","37007",25531,4246,40.4,26699,14.4,39.5,3845,-1168,401,10.43,-0.27,-0.25,-0.258
"1895","37009",26833,6258,47.2,27099,20.3,45.4,5501,-266,757,13.76,-0.22,0.03,-0.07
"1896","37011",17535,3605,44.5,17815,17.7,42.2,3153,-280,452,14.34,-0.26,0.07,-0.062
"1897","37013",47316,10443,45.4,47542,18.6,44,8843,-226,1600,18.09,-0.09,0.38,0.192
"1898","37015",19913,4005,45,21035,17.6,43.1,3702,-1122,303,8.18,-0.28,-0.43,-0.37
"1899","37017",34130,6541,42.8,34922,15.8,41,5518,-792,1023,18.54,-0.18,0.42,0.18
"1900","37019",122586,34408,51.9,107925,21.7,47.6,23420,14661,10988,46.92,1.27,2.74,2.152
"1901","37021",252268,46462,41.9,239000,16.1,40.7,38479,13268,7983,20.75,0.83,0.6,0.692
"1902","37023",88898,16676,43.6,90821,16.2,41.4,14713,-1923,1963,13.34,-0.04,-0.01,-0.022
"1903","37025",196716,24808,37.9,178396,11.3,36.7,20159,18320,4649,23.06,0.35,0.79,0.614
"1904","37027",81805,15071,44.1,82493,15.6,41.2,12869,-688,2202,17.11,-0.01,0.3,0.176
"1905","37029",10336,1657,40.8,9965,14.1,40.1,1405,371,252,17.94,-0.29,0.37,0.106
"1906","37031",68699,15649,47.4,66415,19.2,45.7,12752,2284,2897,22.72,0.09,0.76,0.492
"1907","37033",22833,4440,45.4,23615,16.5,43.6,3896,-782,544,13.96,-0.25,0.04,-0.076
"1908","37035",156182,25875,41.2,154201,14.4,39.7,22205,1981,3670,16.53,0.21,0.25,0.234
"1909","37037",68364,15533,46.3,63896,19,44.1,12140,4468,3393,27.95,0.17,1.19,0.782
"1910","37039",27463,7523,50.8,27304,23.2,48.3,6335,159,1188,18.75,-0.15,0.43,0.198
"1911","37041",14370,3253,44.7,14825,19.7,44.7,2921,-455,332,11.37,-0.28,-0.17,-0.214
"1912","37043",10753,3096,50.7,10575,24,49.6,2538,178,558,21.99,-0.24,0.7,0.324
"1913","37045",97038,16996,41.7,97890,15.3,40.5,14977,-852,2019,13.48,-0.03,0,-0.012
"1914","37047",56589,10484,41.9,57612,15.5,40.4,8930,-1023,1554,17.4,-0.1,0.32,0.152
"1915","37049",103374,17993,36.2,102904,15.4,36.5,15847,470,2146,13.54,-0.01,0.01,0.002
"1916","37051",332766,36612,31,319329,9.6,30.9,30656,13437,5956,19.43,0.54,0.49,0.51
"1917","37053",25247,3898,42.9,23677,12.9,41,3054,1570,844,27.64,-0.2,1.16,0.616
"1918","37055",35412,6819,46,34019,15.3,43.5,5205,1393,1614,31.01,-0.09,1.44,0.828
"1919","37057",164118,27916,42.1,162628,14.6,40.4,23744,1490,4172,17.57,0.28,0.34,0.316
"1920","37059",41766,8061,44.6,41183,16.5,42.6,6795,583,1266,18.63,-0.14,0.43,0.202
"1921","37061",59350,9857,40,58510,14.2,37.4,8308,840,1549,18.64,-0.1,0.43,0.218
"1922","37063",300865,35025,35,269283,9.9,33.4,26659,31582,8366,31.38,0.89,1.47,1.238
"1923","37065",54032,9542,40.3,56253,14.6,40,8213,-2221,1329,16.18,-0.13,0.22,0.08
"1924","37067",368362,54538,38.2,351368,13.1,37.3,46029,16994,8509,18.49,0.91,0.41,0.61
"1925","37069",63866,9927,40.9,60470,12.9,39.8,7801,3396,2126,27.25,-0.02,1.13,0.67
"1926","37071",214049,32728,40.1,206291,13.4,38.8,27643,7758,5085,18.4,0.41,0.41,0.41
"1927","37073",11601,2153,45,12069,15.2,42.4,1834,-468,319,17.39,-0.28,0.32,0.08
"1928","37075",8607,1960,45,8766,19.2,42.7,1683,-159,277,16.46,-0.29,0.25,0.034
"1929","37077",58503,9181,42.5,59666,12.7,39.9,7578,-1163,1603,21.15,-0.09,0.63,0.342
"1930","37079",21059,3094,40.4,21386,12.7,38.1,2716,-327,378,13.92,-0.27,0.04,-0.084
"1931","37081",517197,73156,37.2,489576,12.4,36.4,60707,27621,12449,20.51,1.48,0.58,0.94
"1932","37083",52300,9925,42.7,54693,16.3,41.9,8915,-2393,1010,11.33,-0.18,-0.17,-0.174
"1933","37085",128753,14830,33.9,115559,10.5,33.5,12134,13194,2696,22.22,0.06,0.72,0.456
"1934","37087",59854,14194,47.5,58915,21.4,45.7,12608,939,1586,12.58,-0.1,-0.07,-0.082
"1935","37089",112156,27714,46.9,106577,22.7,45.3,24193,5579,3521,14.55,0.18,0.09,0.126
"1936","37091",24262,4419,42.4,24525,16,40.9,3924,-263,495,12.61,-0.25,-0.07,-0.142
"1937","37093",52571,4556,31.9,47368,7.1,30.8,3363,5203,1193,35.47,-0.15,1.8,1.02
"1938","37095",5507,967,42.7,5810,14.4,40,837,-303,130,15.53,-0.31,0.17,-0.022
"1939","37097",169798,25266,40.4,159614,13,39,20750,10184,4516,21.76,0.33,0.68,0.54
"1940","37099",41725,7673,37.2,39985,15.6,36.6,6238,1740,1435,23,-0.12,0.78,0.42
"1941","37101",186308,23061,37.9,169122,10.4,36.6,17589,17186,5472,31.11,0.47,1.45,1.058
"1942","37103",9776,1994,45.5,10144,18.2,44.4,1846,-368,148,8.02,-0.3,-0.44,-0.384
"1943","37105",59805,9192,37.9,57876,13.8,37.6,7987,1929,1205,15.09,-0.15,0.14,0.024
"1944","37107",57934,10749,41.9,59372,16,41,9500,-1438,1249,13.15,-0.14,-0.02,-0.068
"1945","37109",80504,13133,42.7,78052,13.5,40.8,10537,2452,2596,24.64,0.05,0.92,0.572
"1946","37111",45069,8521,43.3,44926,16.6,41.8,7458,143,1063,14.25,-0.17,0.07,-0.026
"1947","37113",34160,9392,49.3,33815,23.9,48.4,8082,345,1310,16.21,-0.14,0.23,0.082
"1948","37115",21347,4404,44.2,20727,17.9,43.6,3710,620,694,18.71,-0.23,0.43,0.166
"1949","37117",23227,4884,46,24298,17.9,44.1,4349,-1071,535,12.3,-0.25,-0.09,-0.154
"1950","37119",1034290,107167,34.9,926873,8.9,34,82492,107417,24675,29.91,3.25,1.35,2.11
"1951","37121",15155,3586,47.1,15539,20.8,45.3,3232,-384,354,10.95,-0.27,-0.2,-0.228
"1952","37123",27445,5164,42.8,27741,15.9,39.7,4411,-296,753,17.07,-0.22,0.3,0.092
"1953","37125",94191,22394,44.7,88314,22.7,45.1,20047,5877,2347,11.71,0.01,-0.14,-0.08
"1954","37127",94125,15871,41.4,95545,14,40.3,13376,-1420,2495,18.65,0.04,0.43,0.274
"1955","37129",219866,35691,38.7,203276,13.9,37.4,28255,16590,7436,26.32,0.75,1.06,0.936
"1956","37131",20426,4844,48.6,21959,20,45.4,4392,-1533,452,10.29,-0.26,-0.26,-0.26
"1957","37133",192685,16442,26,176461,7.6,25.8,13411,16224,3031,22.6,0.11,0.75,0.494
"1958","37135",141812,17381,34.2,133958,9.9,33.3,13262,7854,4119,31.06,0.27,1.44,0.972
"1959","37137",12803,3436,51,13145,22.1,48,2905,-342,531,18.28,-0.25,0.4,0.14
"1960","37139",39546,6172,38.1,40551,13.6,36.3,5515,-1005,657,11.91,-0.23,-0.13,-0.17
"1961","37141",57630,9973,42.6,52447,15.3,41.2,8024,5183,1949,24.29,-0.04,0.89,0.518
"1962","37143",13506,3483,48.9,13414,21.5,46.3,2884,92,599,20.77,-0.24,0.6,0.264
"1963","37145",39240,7038,43,39322,15.2,41.5,5977,-82,1061,17.75,-0.17,0.35,0.142
"1964","37147",176484,21106,32,167951,10.1,30.9,16963,8533,4143,24.42,0.27,0.9,0.648
"1965","37149",20434,5780,52.1,20386,24.8,49.5,5056,48,724,14.32,-0.22,0.07,-0.046
"1966","37151",142827,23617,41.5,141568,14.1,39.6,19961,1259,3656,18.32,0.2,0.4,0.32
"1967","37153",45447,7598,40.2,46608,14.4,38.9,6712,-1161,886,13.2,-0.2,-0.02,-0.092
"1968","37155",134187,18407,35.9,133920,11.4,34.3,15267,267,3140,20.57,0.13,0.58,0.4
"1969","37157",91566,17306,44.4,93264,16.4,42.2,15295,-1698,2011,13.15,-0.03,-0.02,-0.024
"1970","37159",138940,22800,40.1,138189,14.6,39.1,20176,751,2624,13.01,0.05,-0.04,-0.004
"1971","37161",66523,13350,44.5,67446,17.4,42.1,11736,-923,1614,13.75,-0.09,0.03,-0.018
"1972","37163",63664,10420,40.2,63408,14.3,38.2,9067,256,1353,14.92,-0.13,0.12,0.02
"1973","37165",35445,5759,39.3,36266,13.8,37.8,5005,-821,754,15.06,-0.22,0.13,-0.01
"1974","37167",60875,10970,42.4,60489,15.7,40.5,9497,386,1473,15.51,-0.11,0.17,0.058
"1975","37169",46124,8922,45.3,47224,16.1,42.5,7603,-1100,1319,17.35,-0.13,0.32,0.14
"1976","37171",72315,13855,43.4,73551,16.7,41.1,12283,-1236,1572,12.8,-0.1,-0.05,-0.07
"1977","37173",14208,2700,41.1,13995,16.8,40.9,2351,213,349,14.84,-0.28,0.11,-0.046
"1978","37175",33291,9513,50.6,32825,26.3,49.4,8633,466,880,10.19,-0.2,-0.27,-0.242
"1979","37177",4090,901,47.1,4367,16.6,44.2,725,-277,176,24.28,-0.3,0.89,0.414
"1980","37179",222095,25912,38,201617,9.8,36.3,19758,20478,6154,31.15,0.57,1.45,1.098
"1981","37181",44420,7484,40.6,45183,14.1,38.4,6371,-763,1113,17.47,-0.16,0.33,0.134
"1982","37183",1023811,107751,35.8,905573,8.6,34.5,77879,118238,29872,38.36,4,2.04,2.824
"1983","37185",20190,4618,47.2,20860,19.3,45.1,4026,-670,592,14.7,-0.24,0.1,-0.036
"1984","37187",12331,2710,43.5,13085,18.4,43.6,2408,-754,302,12.54,-0.28,-0.07,-0.154
"1985","37189",53421,7923,30.6,51103,12.4,28.1,6337,2318,1586,25.03,-0.1,0.95,0.53
"1986","37191",124496,18736,37.3,122419,13,36.7,15914,2077,2822,17.73,0.08,0.35,0.242
"1987","37193",68525,13695,44.1,69265,17.2,42.4,11914,-740,1781,14.95,-0.07,0.12,0.044
"1988","37195",81379,13471,40.4,81020,14.4,38.8,11667,359,1804,15.46,-0.06,0.17,0.078
"1989","37197",37825,7076,43.5,38254,16.3,41.8,6235,-429,841,13.49,-0.2,0,-0.08
"1990","37199",17605,4247,46.8,17814,20.7,45.3,3687,-209,560,15.19,-0.24,0.14,-0.012
"1991","38001",2368,543,45.3,2325,24.9,50.2,579,43,-36,-6.22,-0.33,-1.61,-1.098
"1992","38003",10971,2268,44.5,11047,19.7,44,2176,-76,92,4.23,-0.31,-0.75,-0.574
"1993","38005",6875,882,30.7,6677,12.8,32,855,198,27,3.16,-0.32,-0.84,-0.632
"1994","38007",983,180,44.4,838,18.3,49.3,153,145,27,17.65,-0.32,0.34,0.076
"1995","38009",6651,1462,45.2,6449,21.1,47.4,1361,202,101,7.42,-0.31,-0.49,-0.418
"1996","38011",3226,637,42.2,3154,21.5,46.3,678,72,-41,-6.05,-0.33,-1.6,-1.092
"1997","38013",2253,345,35.7,2011,21.6,46.2,434,242,-89,-20.51,-0.34,-2.78,-1.804
"1998","38015",92372,13621,36.6,81941,13.5,37.3,11062,10431,2559,23.13,0.04,0.79,0.49
"1999","38017",170620,18655,32.2,150240,9.8,31.7,14724,20380,3931,26.7,0.24,1.09,0.75
"2000","38019",3817,1006,50.1,3974,25.3,50.7,1005,-157,1,0.1,-0.33,-1.09,-0.786
"2001","38021",5041,1060,43.6,5280,21.9,41.8,1156,-239,-96,-8.3,-0.34,-1.78,-1.204
"2002","38023",2378,634,50.9,2095,25.1,51.7,526,283,108,20.53,-0.31,0.58,0.224
"2003","38025",4349,692,41.2,3648,18.2,43.3,664,701,28,4.22,-0.32,-0.76,-0.584
"2004","38027",2321,499,45.8,2393,23.9,48.4,572,-72,-73,-12.76,-0.34,-2.15,-1.426
"2005","38029",3389,971,52.1,3544,26.1,50.5,925,-155,46,4.97,-0.32,-0.69,-0.542
"2006","38031",3318,733,46.4,3368,22.5,45.7,758,-50,-25,-3.3,-0.33,-1.37,-0.954
"2007","38033",1892,379,42.4,1646,20.1,43,331,246,48,14.5,-0.32,0.09,-0.074
"2008","38035",70130,8053,29.5,66890,10.4,29.5,6957,3240,1096,15.75,-0.17,0.19,0.046
"2009","38037",2387,660,52.2,2380,27.7,49.7,659,7,1,0.15,-0.33,-1.09,-0.786
"2010","38039",2276,677,50.9,2393,27,52,646,-117,31,4.8,-0.32,-0.71,-0.554
"2011","38041",2601,657,47.3,2502,25.5,50.9,638,99,19,2.98,-0.32,-0.86,-0.644
"2012","38043",2457,489,44.3,2426,22.8,48.5,553,31,-64,-11.57,-0.33,-2.05,-1.362
"2013","38045",4106,1009,47.8,4141,24.8,48.6,1027,-35,-18,-1.75,-0.33,-1.24,-0.876
"2014","38047",1932,562,52.9,1972,28.1,51.1,554,-40,8,1.44,-0.32,-0.98,-0.716
"2015","38049",5951,1163,42.8,5478,20.6,45.4,1128,473,35,3.1,-0.32,-0.85,-0.638
"2016","38051",2680,860,53.5,2813,34.3,53.1,965,-133,-105,-10.88,-0.34,-1.99,-1.33
"2017","38053",11679,1068,30.8,6692,13.7,37.6,917,4987,151,16.47,-0.3,0.25,0.03
"2018","38055",9607,2115,46.7,9020,21.7,49.2,1957,587,158,8.07,-0.3,-0.44,-0.384
"2019","38057",8637,1493,44.7,8400,16.1,46.8,1352,237,141,10.43,-0.31,-0.25,-0.274
"2020","38059",30059,4542,38.2,27439,14.6,39.9,4006,2620,536,13.38,-0.25,0,-0.1
"2021","38061",9986,1108,34.2,7830,13.3,36.9,1041,2156,67,6.44,-0.32,-0.57,-0.47
"2022","38063",2971,805,52.5,3115,27.3,51.4,850,-144,-45,-5.29,-0.33,-1.53,-1.05
"2023","38065",1822,452,50.1,1875,17.4,44,326,-53,126,38.65,-0.31,2.07,1.118
"2024","38067",7050,1514,48.2,7383,20.5,47.1,1514,-333,0,0,-0.33,-1.1,-0.792
"2025","38069",4272,971,46.1,4378,24.3,47.4,1064,-106,-93,-8.74,-0.34,-1.82,-1.228
"2026","38071",11574,2174,42.4,11450,18.5,42.3,2118,124,56,2.64,-0.32,-0.88,-0.656
"2027","38073",5411,1117,44.4,5498,20,44.5,1100,-87,17,1.55,-0.32,-0.97,-0.71
"2028","38075",2543,449,39.3,2468,18.1,45.8,447,75,2,0.45,-0.33,-1.06,-0.768
"2029","38077",16333,2669,37.8,16295,14.9,39.9,2428,38,241,9.93,-0.29,-0.29,-0.29
"2030","38079",14657,1560,30.6,14015,9.9,30.4,1387,642,173,12.47,-0.3,-0.08,-0.168
"2031","38081",3883,824,46.3,3876,18.8,45.8,729,7,95,13.03,-0.31,-0.03,-0.142
"2032","38083",1403,377,52,1282,30,53.4,385,121,-8,-2.08,-0.33,-1.27,-0.894
"2033","38085",4420,320,26.9,4193,7.1,26.2,298,227,22,7.38,-0.32,-0.5,-0.428
"2034","38087",674,163,52,768,19.9,49.3,153,-94,10,6.54,-0.32,-0.57,-0.47
"2035","38089",30316,3894,34.3,24682,15.6,38,3850,5634,44,1.14,-0.32,-1.01,-0.734
"2036","38091",1915,404,49.8,1976,22.8,47.8,451,-61,-47,-10.42,-0.33,-1.95,-1.302
"2037","38093",21058,3758,39.7,20965,17,41.9,3564,93,194,5.44,-0.3,-0.66,-0.516
"2038","38095",2258,552,49.4,2264,23.6,48.8,534,-6,18,3.37,-0.32,-0.83,-0.626
"2039","38097",8050,1516,41.4,8105,18.5,42.2,1499,-55,17,1.13,-0.32,-1.01,-0.734
"2040","38099",10920,2248,44.6,11131,20.6,45.6,2293,-211,-45,-1.96,-0.33,-1.26,-0.888
"2041","38101",69628,8182,31,62013,12.8,32.5,7938,7615,244,3.07,-0.29,-0.85,-0.626
"2042","38103",4089,1122,51.8,4228,29.2,51.4,1235,-139,-113,-9.15,-0.34,-1.85,-1.246
"2043","38105",32916,3102,31.3,23287,14,37.6,3260,9629,-158,-4.85,-0.35,-1.5,-1.04
"2044","39001",27926,4633,42.2,28524,15.1,39.8,4307,-598,326,7.57,-0.28,-0.48,-0.4
"2045","39003",104157,16988,38.6,106079,14.8,38.1,15700,-1922,1288,8.2,-0.14,-0.43,-0.314
"2046","39005",53299,9414,40.4,53203,16,39.5,8512,96,902,10.6,-0.2,-0.23,-0.218
"2047","39007",98622,17406,42.5,101262,15.7,41.1,15898,-2640,1508,9.49,-0.11,-0.32,-0.236
"2048","39009",65563,7697,28.6,64592,10.3,26.4,6653,971,1044,15.69,-0.17,0.18,0.04
"2049","39011",45778,7780,41.1,45934,15.5,40.2,7120,-156,660,9.27,-0.23,-0.34,-0.296
"2050","39013",68889,13240,44.2,70182,17.8,43.5,12492,-1293,748,5.99,-0.22,-0.61,-0.454
"2051","39015",43799,7488,41.6,44666,14.4,39.9,6432,-867,1056,16.42,-0.17,0.24,0.076
"2052","39017",375702,51083,36.4,368029,11.7,36.1,43059,7673,8024,18.63,0.84,0.43,0.594
"2053","39019",27825,5430,45,28828,17,43.2,4901,-1003,529,10.79,-0.25,-0.22,-0.232
"2054","39021",39005,6725,42.1,39982,14.6,39.7,5837,-977,888,15.21,-0.2,0.14,0.00399999999999999
"2055","39023",135520,24770,41.2,138278,16.2,40.6,22401,-2758,2369,10.58,0.02,-0.23,-0.13
"2056","39025",202166,29590,39.9,197543,12,38.6,23705,4623,5885,24.83,0.53,0.93,0.77
"2057","39027",41869,6611,39.8,42161,13.5,38.4,5692,-292,919,16.15,-0.19,0.22,0.056
"2058","39029",104584,19604,43.8,107598,16.6,42.3,17861,-3014,1743,9.76,-0.07,-0.3,-0.208
"2059","39031",36602,6602,41.4,36880,16.2,41.3,5975,-278,627,10.49,-0.23,-0.24,-0.236
"2060","39033",42231,8372,43,43623,17.8,42.2,7765,-1392,607,7.82,-0.24,-0.46,-0.372
"2061","39035",1257401,213528,40.4,1278024,15.6,40.2,199372,-20623,14156,7.1,1.72,-0.52,0.376
"2062","39037",51919,9664,41.8,52776,17,40.8,8972,-857,692,7.71,-0.23,-0.47,-0.374
"2063","39039",38311,6544,40,38975,15.5,39.1,6041,-664,503,8.33,-0.25,-0.42,-0.352
"2064","39041",193024,23567,38.4,174454,9.8,37.2,17096,18570,6471,37.85,0.61,2,1.444
"2065","39043",75369,15249,44.6,76952,17.4,43.3,13390,-1583,1859,13.88,-0.06,0.04,0
"2066","39045",151526,22383,39.2,146138,12.4,38.2,18121,5388,4262,23.52,0.29,0.83,0.614
"2067","39047",28659,4791,41.1,28931,15,39.4,4340,-272,451,10.39,-0.26,-0.25,-0.254
"2068","39049",1253507,140469,34,1167484,10,33.5,116748,86023,23721,20.32,3.11,0.56,1.58
"2069","39051",42296,6885,40.2,42635,14.3,39.6,6097,-339,788,12.92,-0.21,-0.04,-0.108
"2070","39053",30203,5301,40.6,30877,15.9,39.8,4909,-674,392,7.99,-0.27,-0.45,-0.378
"2071","39055",93895,17416,44.4,93485,15.7,43.3,14677,410,2739,18.66,0.07,0.43,0.286
"2072","39057",164825,26204,38.1,161936,13.8,37,22347,2889,3857,17.26,0.23,0.31,0.278
"2073","39059",39414,7160,42.4,40056,16.2,40.8,6489,-642,671,10.34,-0.23,-0.25,-0.242
"2074","39061",808703,117092,36.9,801350,13.4,37.1,107381,7353,9711,9.04,1.08,-0.36,0.216
"2075","39063",75508,11982,38.9,75043,14.6,38.4,10956,465,1026,9.36,-0.18,-0.33,-0.27
"2076","39065",31576,4731,35.6,31986,13.5,34.8,4318,-410,413,9.56,-0.27,-0.32,-0.3
"2077","39067",15397,3091,46,15818,18.4,44.2,2911,-421,180,6.18,-0.3,-0.59,-0.474
"2078","39069",27463,4710,41.2,28246,15.6,39.6,4406,-783,304,6.9,-0.28,-0.54,-0.436
"2079","39071",43031,7475,40.3,43454,15.2,39,6605,-423,870,13.17,-0.2,-0.02,-0.092
"2080","39073",28547,5139,42.7,29372,15.5,41.9,4553,-825,586,12.87,-0.24,-0.05,-0.126
"2081","39075",43808,5567,30.8,42501,11.6,29.7,4930,1307,637,12.92,-0.23,-0.04,-0.116
"2082","39077",58497,9210,39.2,59628,13.7,37.6,8169,-1131,1041,12.74,-0.17,-0.06,-0.104
"2083","39079",32624,5230,40.2,33134,14.3,39.1,4738,-510,492,10.38,-0.25,-0.25,-0.25
"2084","39081",67349,13545,44.7,69343,18.4,43.9,12759,-1994,786,6.16,-0.21,-0.6,-0.444
"2085","39083",60945,10207,38.9,60791,14.8,39,8997,154,1210,13.45,-0.15,0,-0.06
"2086","39085",229701,42377,43.5,229873,16.2,42.5,37239,-172,5138,13.8,0.42,0.03,0.186
"2087","39087",61057,10906,41.5,62441,15.6,40,9741,-1384,1165,11.96,-0.16,-0.12,-0.136
"2088","39089",170678,26300,39.9,166135,13.4,39.1,22262,4543,4038,18.14,0.26,0.38,0.332
"2089","39091",45323,7534,41,45816,15,39.6,6872,-493,662,9.63,-0.23,-0.31,-0.278
"2090","39093",305405,51341,41.5,301108,14.5,40.1,43661,4297,7680,17.59,0.79,0.34,0.52
"2091","39095",433404,64876,37.9,441198,13.3,37.1,58679,-7794,6197,10.56,0.57,-0.24,0.084
"2092","39097",43732,6335,40.4,43213,12.6,39,5445,519,890,16.35,-0.2,0.24,0.064
"2093","39099",231857,45430,43.5,238352,17.9,42.9,42665,-6495,2765,6.48,0.07,-0.57,-0.314
"2094","39101",65483,10859,40.8,66514,14.1,40,9378,-1031,1481,15.79,-0.11,0.19,0.07
"2095","39103",176362,28430,41.9,172334,13.3,40.5,22920,4028,5510,24.04,0.47,0.87,0.71
"2096","39105",23234,4191,42.8,23664,15.8,41.5,3739,-430,452,12.09,-0.26,-0.11,-0.17
"2097","39107",40723,6757,39.8,40866,15.7,39.4,6416,-143,341,5.31,-0.28,-0.67,-0.514
"2098","39109",104081,18294,41.5,102657,15.4,40.8,15809,1424,2485,15.72,0.03,0.19,0.126
"2099","39111",14239,3087,45.8,14679,19.6,45,2877,-440,210,7.3,-0.3,-0.5,-0.42
"2100","39113",531987,90175,39.3,535626,15.3,39.2,81951,-3639,8224,10.04,0.87,-0.28,0.18
"2101","39115",14773,2902,44.2,15042,18,43.2,2708,-269,194,7.16,-0.3,-0.51,-0.426
"2102","39117",34935,5512,41.8,34895,13.6,39.6,4746,40,766,16.14,-0.21,0.22,0.048
"2103","39119",85933,14441,40.2,85996,15.3,39.6,13157,-63,1284,9.76,-0.14,-0.3,-0.236
"2104","39121",14498,3639,48.7,14643,22.2,44.5,3251,-145,388,11.93,-0.27,-0.12,-0.18
"2105","39123",40769,9276,48.3,41445,19.3,46.5,7999,-676,1277,15.96,-0.14,0.21,0.07
"2106","39125",18951,3281,41.5,19522,15,40.5,2928,-571,353,12.06,-0.27,-0.11,-0.174
"2107","39127",35983,5617,39.9,36086,12.9,38.3,4655,-103,962,20.67,-0.19,0.59,0.278
"2108","39129",57075,8478,39.4,55795,12.9,38.4,7198,1280,1280,17.78,-0.14,0.36,0.16
"2109","39131",28291,4758,41,28652,14.6,39.8,4183,-361,575,13.75,-0.24,0.03,-0.078
"2110","39133",162080,24201,37.8,161178,12.9,37.4,20792,902,3409,16.4,0.17,0.24,0.212
"2111","39135",41328,7290,42.3,42240,15.4,41,6505,-912,785,12.07,-0.21,-0.11,-0.15
"2112","39137",34037,5437,39.6,34445,14.4,38.8,4960,-408,477,9.62,-0.26,-0.31,-0.29
"2113","39139",121533,22520,41.4,124286,16.5,41,20507,-2753,2013,9.82,-0.03,-0.3,-0.192
"2114","39141",77125,11882,40.5,77741,13.7,39.8,10651,-616,1231,11.56,-0.15,-0.15,-0.15
"2115","39143",59559,10380,41.7,60842,15.5,40.9,9431,-1283,949,10.06,-0.19,-0.28,-0.244
"2116","39145",76871,13129,39.8,79122,15.6,38.7,12343,-2251,786,6.37,-0.21,-0.58,-0.432
"2117","39147",55549,9229,39.5,56630,14.7,38.8,8325,-1081,904,10.86,-0.19,-0.21,-0.202
"2118","39149",48902,7324,39.3,49359,13.1,38.3,6466,-457,858,13.27,-0.2,-0.01,-0.086
"2119","39151",374273,67891,41.8,375593,16.3,41.2,61222,-1320,6669,10.89,0.64,-0.21,0.13
"2120","39153",541318,89800,40.8,541788,14.7,40.2,79643,-470,10157,12.75,1.15,-0.06,0.424
"2121","39155",203341,40413,44,209942,17.5,42.8,36740,-6601,3673,10,0.21,-0.28,-0.084
"2122","39157",92531,17053,40.9,92532,16.4,40.8,15175,-1,1878,12.38,-0.05,-0.09,-0.074
"2123","39159",54688,6185,38.3,52153,9.6,36.8,5007,2535,1178,23.53,-0.16,0.83,0.434
"2124","39161",28262,5046,41.4,28808,16.7,40.2,4811,-546,235,4.88,-0.29,-0.7,-0.536
"2125","39163",13142,2087,41.9,13397,14.5,39.5,1943,-255,144,7.41,-0.3,-0.49,-0.414
"2126","39165",223868,29508,39.1,213146,10.9,37.5,23233,10722,6275,27.01,0.58,1.11,0.898
"2127","39167",60871,11921,43.8,61751,17.5,42.7,10806,-880,1115,10.32,-0.16,-0.26,-0.22
"2128","39169",115915,19144,38.7,114644,14.7,38.4,16853,1271,2291,13.59,0.01,0.01,0.01
"2129","39171",37061,6550,41.4,37779,16.1,40.6,6082,-718,468,7.69,-0.26,-0.47,-0.386
"2130","39173",129504,18289,34.6,126254,12.4,35.1,15655,3250,2634,16.83,0.06,0.28,0.192
"2131","39175",22190,3994,41.3,22626,16.5,41.4,3733,-436,261,6.99,-0.29,-0.53,-0.434
"2132","40001",22136,3318,37.2,22470,13.1,36.8,2944,-334,374,12.7,-0.27,-0.06,-0.144
"2133","40003",5877,1095,43.8,5631,20.3,46,1143,246,-48,-4.2,-0.33,-1.45,-1.002
"2134","40005",13899,2565,40.8,14133,15.8,39.3,2233,-234,332,14.87,-0.28,0.12,-0.04
"2135","40007",5445,996,40.5,5587,16.2,40.9,905,-142,91,10.06,-0.31,-0.28,-0.292
"2136","40009",22971,2946,35.1,22519,12.5,35.1,2815,452,131,4.65,-0.31,-0.72,-0.556
"2137","40011",9680,1763,42.1,10651,16,40.4,1704,-971,59,3.46,-0.32,-0.82,-0.62
"2138","40013",45068,7796,37.8,42494,15.9,36.8,6757,2574,1039,15.38,-0.18,0.16,0.024
"2139","40015",29437,4722,37.1,29403,14.7,38.1,4322,34,400,9.25,-0.27,-0.34,-0.312
"2140","40017",132922,16329,35.8,116299,11.1,35.7,12909,16623,3420,26.49,0.17,1.07,0.71
"2141","40019",48407,7637,38.1,47603,15.2,38.3,7236,804,401,5.54,-0.27,-0.65,-0.498
"2142","40021",48404,7495,35,47165,13.6,34.5,6414,1239,1081,16.85,-0.17,0.28,0.1
"2143","40023",14979,2956,42.5,15172,18.2,40.6,2761,-193,195,7.06,-0.3,-0.52,-0.432
"2144","40025",2221,530,44.6,2451,22.3,44.3,547,-230,-17,-3.11,-0.33,-1.36,-0.948
"2145","40027",274024,33224,33.6,256550,10.4,32.7,26681,17474,6543,24.52,0.62,0.91,0.794
"2146","40029",5666,1127,41.8,5906,18,40.5,1063,-240,64,6.02,-0.32,-0.61,-0.494
"2147","40031",123066,14221,32.6,123101,10.3,31.5,12679,-35,1542,12.16,-0.1,-0.1,-0.1
"2148","40033",6000,1129,41.1,6171,17.7,40.2,1092,-171,37,3.39,-0.32,-0.82,-0.62
"2149","40035",14563,2811,42.5,14922,17.3,42,2582,-359,229,8.87,-0.29,-0.37,-0.338
"2150","40037",70899,11901,40.3,69934,15.1,40.1,10560,965,1341,12.7,-0.13,-0.06,-0.088
"2151","40039",29169,3839,30.7,27583,13.3,31.1,3669,1586,170,4.63,-0.3,-0.72,-0.552
"2152","40041",41878,9935,46.5,41332,20.5,44.9,8473,546,1462,17.25,-0.11,0.31,0.142
"2153","40043",4904,939,40.6,4775,19.8,42.3,945,129,-6,-0.63,-0.33,-1.15,-0.822
"2154","40045",4102,859,44.1,4095,19.8,44.8,811,7,48,5.92,-0.32,-0.62,-0.5
"2155","40047",62421,9507,35.7,60272,15.4,37.5,9282,2149,225,2.42,-0.29,-0.9,-0.656
"2156","40049",27751,4804,39.2,27471,16.9,39.7,4643,280,161,3.47,-0.3,-0.82,-0.612
"2157","40051",54351,8238,38.6,52451,13.7,38.2,7186,1900,1052,14.64,-0.17,0.1,-0.00800000000000001
"2158","40053",4458,926,44,4536,21.3,45.1,966,-78,-40,-4.14,-0.33,-1.44,-0.996
"2159","40055",6018,1065,39.6,6185,18.4,42.1,1138,-167,-73,-6.41,-0.34,-1.63,-1.114
"2160","40057",2758,505,42.4,2888,17.7,41.2,511,-130,-6,-1.17,-0.33,-1.2,-0.852
"2161","40059",3843,669,38.9,3672,18.5,40.5,679,171,-10,-1.47,-0.33,-1.22,-0.864
"2162","40061",12746,2494,40.3,12761,18.2,39.6,2323,-15,171,7.36,-0.3,-0.5,-0.42
"2163","40063",13519,2510,39.8,13762,17.7,39.9,2436,-243,74,3.04,-0.31,-0.85,-0.634
"2164","40065",25574,3633,34.2,26275,13.1,34.3,3442,-701,191,5.55,-0.3,-0.65,-0.51
"2165","40067",6270,1236,42.4,6445,19.3,41.6,1244,-175,-8,-0.64,-0.33,-1.15,-0.822
"2166","40069",11039,1971,39.4,10938,16.5,39.4,1805,101,166,9.2,-0.3,-0.35,-0.33
"2167","40071",45173,8307,38.6,46288,17,39.3,7869,-1115,438,5.57,-0.26,-0.64,-0.488
"2168","40073",15510,2363,36.6,14965,15,38.3,2245,545,118,5.26,-0.31,-0.67,-0.526
"2169","40075",9127,1751,43.1,9421,18.6,41.8,1752,-294,-1,-0.06,-0.33,-1.11,-0.798
"2170","40077",10621,2190,40.8,11099,17.3,39.9,1920,-478,270,14.06,-0.29,0.05,-0.086
"2171","40079",49860,8574,39.6,50056,15.3,38.5,7659,-196,915,11.95,-0.19,-0.12,-0.148
"2172","40081",34759,6020,41,34106,15.5,40.4,5286,653,734,13.89,-0.22,0.04,-0.064
"2173","40083",45326,6499,37.8,41982,13.4,37.4,5626,3344,873,15.52,-0.2,0.17,0.022
"2174","40085",9843,1832,40,9404,17,41,1599,439,233,14.57,-0.29,0.09,-0.062
"2175","40087",37919,5577,38.3,34471,13.2,38.2,4550,3448,1027,22.57,-0.18,0.75,0.378
"2176","40089",33026,5688,39,33144,15.5,38.8,5137,-118,551,10.73,-0.25,-0.22,-0.232
"2177","40091",19874,4813,47,20266,22.5,46.7,4560,-392,253,5.55,-0.29,-0.65,-0.506
"2178","40093",7730,1511,41.7,7563,19.2,43.6,1452,167,59,4.06,-0.32,-0.77,-0.59
"2179","40095",16226,3515,43.2,15774,19.5,42.7,3076,452,439,14.27,-0.26,0.07,-0.062
"2180","40097",40929,7169,40.3,41162,15.6,39.2,6421,-233,748,11.65,-0.22,-0.15,-0.178
"2181","40099",13797,2593,42.2,13460,17.5,41.4,2356,337,237,10.06,-0.29,-0.28,-0.284
"2182","40101",69471,11080,37.7,70635,14.8,38,10454,-1164,626,5.99,-0.24,-0.61,-0.462
"2183","40103",11421,2062,41.5,11540,16.9,40.1,1950,-119,112,5.74,-0.31,-0.63,-0.502
"2184","40105",10448,1949,42.3,10627,17.9,41.5,1902,-179,47,2.47,-0.32,-0.9,-0.668
"2185","40107",12160,2070,40,12203,16.4,40.3,2001,-43,69,3.45,-0.32,-0.82,-0.62
"2186","40109",774203,98841,34.4,721088,12,34.3,86531,53115,12310,14.23,1.46,0.06,0.62
"2187","40111",39121,6772,39.2,39770,15.7,38.7,6244,-649,528,8.46,-0.25,-0.41,-0.346
"2188","40113",47350,8514,42,47650,16,41.6,7624,-300,890,11.67,-0.2,-0.15,-0.17
"2189","40115",31725,5641,38.2,31940,17.3,38.7,5526,-215,115,2.08,-0.31,-0.93,-0.682
"2190","40117",16448,3011,41.7,16573,16.6,41.7,2751,-125,260,9.45,-0.29,-0.33,-0.314
"2191","40119",80634,9354,27.2,77125,10.4,27.2,8021,3509,1333,16.62,-0.13,0.26,0.104
"2192","40121",44673,8533,41,45570,17.4,41.2,7929,-897,604,7.62,-0.24,-0.48,-0.384
"2193","40123",38289,6110,35.5,37438,14.9,35.5,5578,851,532,9.54,-0.25,-0.32,-0.292
"2194","40125",71614,11160,37.6,69676,14.3,37.3,9964,1938,1196,12,-0.15,-0.12,-0.132
"2195","40127",11132,2458,44.6,11449,20.7,44.4,2370,-317,88,3.71,-0.31,-0.8,-0.604
"2196","40129",3734,703,41,3678,18,41.8,662,56,41,6.19,-0.32,-0.59,-0.482
"2197","40131",90098,13777,38.7,87031,13.5,38.5,11749,3067,2028,17.26,-0.03,0.31,0.174
"2198","40133",25246,4342,39.2,25394,16.4,39.2,4165,-148,177,4.25,-0.3,-0.75,-0.57
"2199","40135",41364,7265,40.7,41945,15.2,38.9,6376,-581,889,13.94,-0.2,0.04,-0.056
"2200","40137",44293,8082,40.5,44848,17.5,40.1,7848,-555,234,2.98,-0.29,-0.86,-0.632
"2201","40139",21409,2331,32.5,20620,10.2,31,2103,789,228,10.84,-0.29,-0.21,-0.242
"2202","40141",7591,1454,40.9,7981,17.8,40.5,1421,-390,33,2.32,-0.32,-0.91,-0.674
"2203","40143",637123,84958,35.4,602692,12.2,35.3,73528,34431,11430,15.55,1.33,0.17,0.634
"2204","40145",76830,11618,38.5,73067,12.8,38,9353,3763,2265,24.22,0,0.88,0.528
"2205","40147",51867,9729,40.1,51112,17.8,41,9098,755,631,6.94,-0.23,-0.53,-0.41
"2206","40149",11550,1981,38.6,11616,17.5,39.3,2033,-66,-52,-2.56,-0.33,-1.31,-0.918
"2207","40151",9132,1470,33.8,8741,17.1,35.6,1495,391,-25,-1.67,-0.33,-1.24,-0.876
"2208","40153",21140,2972,36,20232,14.5,37.2,2934,908,38,1.3,-0.32,-0.99,-0.722
"2209","41001",15980,3975,47.9,16092,22.3,48.1,3589,-112,386,10.76,-0.27,-0.22,-0.24
"2210","41003",88249,12918,32.8,85501,12.2,32.1,10431,2748,2487,23.84,0.03,0.85,0.522
"2211","41005",399962,66033,41.4,377206,13.8,40.6,52054,22756,13979,26.85,1.7,1.1,1.34
"2212","41007",38021,7638,44.1,37068,17.2,43.5,6376,953,1262,19.79,-0.14,0.52,0.256
"2213","41009",50207,8806,43.3,49317,14,41.5,6904,890,1902,27.55,-0.05,1.16,0.676
"2214","41011",62921,15340,48.3,62937,21.7,47.2,13657,-16,1683,12.32,-0.08,-0.09,-0.086
"2215","41013",21717,5246,48,21102,20.4,45.7,4305,615,941,21.86,-0.19,0.69,0.338
"2216","41015",22377,7223,55.6,22344,27.9,53.2,6234,33,989,15.86,-0.18,0.2,0.048
"2217","41017",175321,32437,42.1,158884,15.1,40.4,23991,16437,8446,35.2,0.9,1.78,1.428
"2218","41019",107576,25922,47,107391,21.2,46.1,22767,185,3155,13.86,0.13,0.03,0.07
"2219","41021",1910,480,47,1904,21.3,50.2,406,6,74,18.23,-0.31,0.39,0.11
"2220","41023",7209,1983,53,7366,23.7,50,1746,-157,237,13.57,-0.29,0.01,-0.11
"2221","41025",7195,1599,46.2,7359,19.1,46.1,1406,-164,193,13.73,-0.3,0.02,-0.108
"2222","41027",22938,3344,39,22207,12.6,37.8,2798,731,546,19.51,-0.25,0.5,0.2
"2223","41029",212070,43506,43,203613,17.8,42,36243,8457,7263,20.04,0.73,0.54,0.616
"2224","41031",22707,4144,40.6,21746,15.3,40.1,3327,961,817,24.56,-0.21,0.91,0.462
"2225","41033",84514,21066,47.6,82636,22.3,47.1,18428,1878,2638,14.32,0.06,0.07,0.066
"2226","41035",66018,12974,42.6,66350,17.3,41.6,11479,-332,1495,13.02,-0.11,-0.03,-0.062
"2227","41037",7807,1848,48.8,7886,20.2,48,1593,-79,255,16.01,-0.29,0.21,0.01
"2228","41039",363471,64464,39.4,351794,15.2,38.8,53473,11677,10991,20.55,1.27,0.58,0.856
"2229","41041",47307,12271,50.9,45992,21.9,49.6,10072,1315,2199,21.83,-0.01,0.69,0.41
"2230","41043",121074,21303,39.7,116871,15.5,39,18115,4203,3188,17.6,0.14,0.34,0.26
"2231","41045",30421,4861,36.1,31057,15.1,36.2,4690,-636,171,3.65,-0.3,-0.8,-0.6
"2232","41047",330453,48274,36.2,315391,13,35.1,41001,15062,7273,17.74,0.73,0.35,0.502
"2233","41049",11153,1707,39.2,11146,12.3,36.6,1371,7,336,24.51,-0.28,0.91,0.434
"2234","41051",788459,96693,36.8,737110,10.7,35.9,78871,51349,17822,22.6,2.26,0.75,1.354
"2235","41053",79666,13426,37.3,75448,15.2,37.4,11468,4218,1958,17.07,-0.04,0.3,0.164
"2236","41055",1635,420,51.7,1865,21.5,46.7,401,-230,19,4.74,-0.32,-0.71,-0.554
"2237","41057",25840,6114,48,25254,20.9,47.9,5278,586,836,15.84,-0.2,0.2,0.04
"2238","41059",76736,11176,36.1,75846,12.8,35.7,9708,890,1468,15.12,-0.11,0.14,0.04
"2239","41061",25810,4852,39.8,25670,16.8,40.1,4313,140,539,12.5,-0.25,-0.08,-0.148
"2240","41063",6864,1877,52.7,6938,23.3,50.8,1617,-74,260,16.08,-0.29,0.22,0.016
"2241","41065",25687,4996,40.9,25113,17.9,41.8,4495,574,501,11.15,-0.25,-0.19,-0.214
"2242","41067",572071,69465,36.4,531818,10.2,35.4,54245,40253,15220,28.06,1.88,1.2,1.472
"2243","41069",1415,474,57.9,1287,31.5,56,405,128,69,17.04,-0.32,0.29,0.046
"2244","41071",102366,16234,38.2,99119,13.7,37.1,13579,3247,2655,19.55,0.06,0.5,0.324
"2245","42001",101589,18883,43.3,101352,15.9,41.3,16115,237,2768,17.18,0.08,0.31,0.218
"2246","42003",1229605,218085,40.9,1224772,16.8,41.2,205762,4833,12323,5.99,1.46,-0.61,0.218
"2247","42005",66737,13631,46,68942,18.6,44.6,12823,-2205,808,6.3,-0.21,-0.59,-0.438
"2248","42007",168161,33634,44.9,170614,18.6,44.2,31734,-2453,1900,5.99,-0.05,-0.61,-0.386
"2249","42009",48891,10503,45.9,49680,19,43.8,9439,-789,1064,11.27,-0.17,-0.18,-0.176
"2250","42011",415500,67608,39.9,411094,14.6,39.4,60020,4406,7588,12.64,0.77,-0.07,0.266
"2251","42013",124736,24172,43.1,127133,17.8,42.1,22630,-2397,1542,6.81,-0.1,-0.54,-0.364
"2252","42015",61546,12232,44.4,62628,17.7,43.1,11085,-1082,1147,10.35,-0.16,-0.25,-0.214
"2253","42017",626486,107340,43.6,625485,14.7,41.9,91946,1001,15394,16.74,1.9,0.27,0.922
"2254","42019",185984,32091,43.1,183946,15.3,41.3,28144,2038,3947,14.02,0.25,0.05,0.13
"2255","42021",135871,28395,45,143305,19,43.7,27228,-7434,1167,4.29,-0.16,-0.75,-0.514
"2256","42023",4754,1184,50.8,5058,21.4,47.9,1082,-304,102,9.43,-0.31,-0.33,-0.322
"2257","42025",63987,12626,45.7,65101,17.9,44,11653,-1114,973,8.35,-0.18,-0.42,-0.324
"2258","42027",160646,20703,31.3,153758,11.4,28.9,17528,6888,3175,18.11,0.13,0.38,0.28
"2259","42029",514652,77047,40.3,499548,13,39.4,64941,15104,12106,18.64,1.43,0.43,0.83
"2260","42031",38747,7109,41.3,39991,16.5,39.6,6599,-1244,510,7.73,-0.25,-0.47,-0.382
"2261","42033",80539,15445,44.2,81668,17.7,42.8,14455,-1129,990,6.85,-0.18,-0.54,-0.396
"2262","42035",39321,6934,38.5,39261,16.3,38.7,6400,60,534,8.34,-0.25,-0.42,-0.352
"2263","42037",66615,11932,40.5,66984,16.1,39.7,10784,-369,1148,10.65,-0.16,-0.23,-0.202
"2264","42039",86847,16455,42.8,88492,16.6,41.7,14690,-1645,1765,12.01,-0.07,-0.12,-0.1
"2265","42041",245801,42707,40.5,235314,15.7,40.5,36944,10487,5763,15.6,0.51,0.18,0.312
"2266","42043",273329,43002,39.6,267891,13.9,39.2,37237,5438,5765,15.48,0.51,0.17,0.306
"2267","42045",563384,86922,39,558874,14.4,38.8,80478,4510,6444,8.01,0.61,-0.44,-0.02
"2268","42047",30781,6385,46.7,31981,19.1,45.1,6108,-1200,277,4.54,-0.29,-0.73,-0.554
"2269","42049",277794,45175,39,280181,14.6,38.5,40906,-2387,4269,10.44,0.29,-0.25,-0.034
"2270","42051",133160,26085,44.6,136914,18.1,43.3,24781,-3754,1304,5.26,-0.14,-0.67,-0.458
"2271","42053",7388,1575,39.2,7664,18.9,43.1,1448,-276,127,8.77,-0.31,-0.38,-0.352
"2272","42055",153003,28244,41.3,149554,16.7,40.2,24976,3449,3268,13.08,0.15,-0.03,0.042
"2273","42057",14631,2945,44.6,14829,17.3,42,2565,-198,380,14.81,-0.27,0.11,-0.042
"2274","42059",37338,6511,42,38614,15.5,41.3,5985,-1276,526,8.79,-0.25,-0.38,-0.328
"2275","42061",45686,8728,42.9,45931,16.4,41.5,7533,-245,1195,15.86,-0.15,0.2,0.06
"2276","42063",86551,15273,39.7,88648,15.7,38.2,13918,-2097,1355,9.74,-0.13,-0.3,-0.232
"2277","42065",44258,8716,43.9,45051,18.3,43,8244,-793,472,5.73,-0.26,-0.63,-0.482
"2278","42067",24448,4669,42.8,24664,17.4,41.1,4292,-216,377,8.78,-0.27,-0.38,-0.336
"2279","42069",211960,40155,42.2,214353,17.8,42.1,38155,-2393,2000,5.24,-0.04,-0.67,-0.418
"2280","42071",536494,89833,38.5,519913,15.1,38,78507,16581,11326,14.43,1.31,0.08,0.572
"2281","42073",88231,18234,44.9,90885,18.9,43.7,17177,-2654,1057,6.15,-0.17,-0.6,-0.428
"2282","42075",137616,25475,41.2,133578,17.1,40.8,22842,4038,2633,11.53,0.06,-0.16,-0.072
"2283","42077",360774,57431,39.4,350165,14.9,39.3,52175,10609,5256,10.07,0.44,-0.28,0.00800000000000001
"2284","42079",318222,60908,43,320555,18.1,42.7,58020,-2333,2888,4.98,0.09,-0.69,-0.378
"2285","42081",115398,20711,41,116447,16.4,41.2,19097,-1049,1614,8.45,-0.09,-0.41,-0.282
"2286","42083",42070,7644,42.5,43451,17.1,41.8,7430,-1381,214,2.88,-0.29,-0.87,-0.638
"2287","42085",113623,22962,44.4,116474,18.6,42.8,21664,-2851,1298,5.99,-0.14,-0.61,-0.422
"2288","42087",46452,9501,43.6,46694,18.6,42.5,8685,-242,816,9.4,-0.21,-0.33,-0.282
"2289","42089",167306,26292,42.6,169346,13,40,22015,-2040,4277,19.43,0.29,0.49,0.41
"2290","42091",818677,136321,41.2,799886,15.2,40.6,121583,18791,14738,12.12,1.81,-0.11,0.658
"2291","42093",18302,3684,43,18243,18.6,43.7,3393,59,291,8.58,-0.28,-0.4,-0.352
"2292","42095",300941,53491,42,297519,15.8,40.9,47008,3422,6483,13.79,0.61,0.03,0.262
"2293","42097",93038,18640,44.3,94441,18.5,43.2,17472,-1403,1168,6.68,-0.16,-0.55,-0.394
"2294","42099",45878,7739,43,45791,13.7,41,6273,87,1466,23.37,-0.11,0.81,0.442
"2295","42101",1569657,203007,34.1,1525811,12.2,33.5,186149,43846,16858,9.06,2.12,-0.36,0.632
"2296","42103",55687,11423,47,57437,16.6,43.8,9535,-1750,1888,19.8,-0.05,0.52,0.292
"2297","42105",17070,3791,46.7,17466,19.7,44.8,3441,-396,350,10.17,-0.27,-0.27,-0.27
"2298","42107",144287,27956,44.2,147935,18.3,43.2,27072,-3648,884,3.27,-0.2,-0.83,-0.578
"2299","42109",40570,7020,39.7,39620,15.5,39.2,6141,950,879,14.31,-0.2,0.07,-0.038
"2300","42111",75619,15816,45.9,77638,18.8,44.4,14596,-2019,1220,8.36,-0.15,-0.42,-0.312
"2301","42113",6192,1667,53.1,6453,24.5,49.7,1581,-261,86,5.44,-0.31,-0.66,-0.52
"2302","42115",41716,8911,47.8,43171,18.1,45.1,7814,-1455,1097,14.04,-0.17,0.05,-0.038
"2303","42117",41550,8404,44,42081,18.1,42.3,7617,-531,787,10.33,-0.21,-0.25,-0.234
"2304","42119",45056,7571,39.4,44944,15,38.4,6742,112,829,12.3,-0.21,-0.09,-0.138
"2305","42121",52880,10791,46,54865,18,44.4,9876,-1985,915,9.26,-0.19,-0.34,-0.28
"2306","42123",40345,8600,46.7,41613,18.9,45.1,7865,-1268,735,9.35,-0.22,-0.34,-0.292
"2307","42125",207661,39937,44.4,207916,17.6,43.5,36593,-255,3344,9.14,0.16,-0.35,-0.146
"2308","42127",51656,11571,47.7,52299,19.1,45.6,9989,-643,1582,15.84,-0.1,0.2,0.08
"2309","42129",356835,75289,46.6,364877,19,45.1,69327,-8042,5962,8.6,0.54,-0.4,-0.024
"2310","42131",27760,5300,44,28221,16.1,42,4544,-461,756,16.64,-0.22,0.26,0.068
"2311","42133",442216,72001,41,434579,14.2,40.1,61710,7637,10291,16.68,1.16,0.27,0.626
"2312","44001",49028,9358,44.1,49796,17,43,8465,-768,893,10.55,-0.2,-0.24,-0.224
"2313","44003",164012,28858,43.7,166066,15.9,42.6,26404,-2054,2454,9.29,0.03,-0.34,-0.192
"2314","44005",83204,16758,44.6,82503,17.3,43.5,14273,701,2485,17.41,0.03,0.33,0.21
"2315","44007",633704,91772,37.3,627414,13.5,37,84701,6290,7071,8.35,0.7,-0.42,0.028
"2316","44009",126190,23398,44.1,126692,15.2,41.9,19257,-502,4141,21.5,0.27,0.66,0.504
"2317","45001",24788,4974,43.7,25387,16.9,42.4,4290,-599,684,15.94,-0.23,0.2,0.028
"2318","45003",165707,29500,41,160169,15.6,40.1,24986,5538,4514,18.07,0.33,0.38,0.36
"2319","45005",9402,1711,40.6,10399,13.5,38.3,1404,-997,307,21.87,-0.28,0.69,0.302
"2320","45007",194174,33445,40.5,187228,15.3,40,28646,6946,4799,16.75,0.37,0.27,0.31
"2321","45009",14842,2899,41.8,15941,16.2,38.9,2582,-1099,317,12.28,-0.28,-0.1,-0.172
"2322","45011",21788,3627,40.6,22523,14.2,38.9,3198,-735,429,13.41,-0.26,0,-0.104
"2323","45013",179316,44675,44,162316,20.7,41.2,33599,17000,11076,32.97,1.28,1.6,1.472
"2324","45015",204632,25975,35.8,179773,10.2,34.6,18337,24859,7638,41.65,0.78,2.31,1.698
"2325","45017",14808,3097,45.9,15134,16.6,43.9,2512,-326,585,23.29,-0.24,0.81,0.39
"2326","45019",387847,58018,37.2,352548,12.9,35.8,45479,35299,12539,27.57,1.49,1.16,1.292
"2327","45021",56549,8846,38.9,55351,13.6,38.2,7528,1198,1318,17.51,-0.13,0.33,0.146
"2328","45023",32424,5647,41.8,33028,14.9,40.3,4921,-604,726,14.75,-0.22,0.11,-0.022
"2329","45025",46127,7672,41.9,46462,13.8,39.2,6412,-335,1260,19.65,-0.14,0.51,0.25
"2330","45027",34156,7179,43.6,34746,16.9,41.9,5872,-590,1307,22.26,-0.14,0.72,0.376
"2331","45029",37581,7050,42.2,38665,15.8,41,6109,-1084,941,15.4,-0.19,0.16,0.02
"2332","45031",67572,11578,41.2,68500,14.4,39.3,9864,-928,1714,17.38,-0.08,0.32,0.16
"2333","45033",31073,4812,37.4,31733,13.3,37.5,4220,-660,592,14.03,-0.24,0.05,-0.066
"2334","45035",151716,18918,36.2,136836,10.2,35.6,13957,14880,4961,35.54,0.39,1.81,1.242
"2335","45037",26620,4589,42.6,26763,13.3,40.6,3559,-143,1030,28.94,-0.18,1.27,0.69
"2336","45039",22868,4297,45.4,23804,15.2,42.5,3618,-936,679,18.77,-0.23,0.44,0.172
"2337","45041",138537,21302,38.8,136714,13.2,37.5,18046,1823,3256,18.04,0.15,0.38,0.288
"2338","45043",61065,15363,48.5,60285,20.2,45.6,12178,780,3185,26.15,0.14,1.04,0.68
"2339","45045",490332,71757,38,452931,12.9,37.2,58428,37401,13329,22.81,1.6,0.77,1.102
"2340","45047",69981,12185,39.3,69531,15.3,38.3,10638,450,1547,14.54,-0.1,0.09,0.014
"2341","45049",20066,3394,39.9,20987,13.8,38.9,2896,-921,498,17.2,-0.25,0.31,0.086
"2342","45051",310186,66092,44.4,270943,17.3,41.4,46873,39243,19219,41,2.46,2.26,2.34
"2343","45053",27465,4370,38.1,24792,11.8,35.5,2925,2673,1445,49.4,-0.12,2.95,1.722
"2344","45055",63734,10905,41.8,61583,14.4,40.8,8868,2151,2037,22.97,-0.03,0.78,0.456
"2345","45057",86544,16985,42,76364,15.8,40.1,12066,10180,4919,40.77,0.39,2.24,1.5
"2346","45059",66508,11413,40.8,66623,15.1,40.1,10060,-115,1353,13.45,-0.13,0,-0.052
"2347","45061",17897,3004,41.7,19160,13.7,38.4,2625,-1263,379,14.44,-0.27,0.08,-0.06
"2348","45063",281870,41096,38.9,262424,12.4,37.7,32541,19446,8555,26.29,0.91,1.05,0.994
"2349","45065",9694,3002,52.8,10140,24.7,49.9,2505,-446,497,19.84,-0.25,0.52,0.212
"2350","45067",31765,5578,40,33038,14.8,39.1,4890,-1273,688,14.07,-0.23,0.05,-0.062
"2351","45069",27505,4536,39.9,28750,13.3,39.1,3824,-1245,712,18.62,-0.22,0.42,0.164
"2352","45071",37914,6948,41.5,37432,16,39.9,5989,482,959,16.01,-0.19,0.21,0.05
"2353","45073",75926,16644,45,74038,19,43.2,14067,1888,2577,18.32,0.05,0.4,0.26
"2354","45075",89116,15921,39.5,92229,15,37.9,13834,-3113,2087,15.09,-0.02,0.14,0.076
"2355","45077",121449,18862,36.2,119167,13.5,34.8,16088,2282,2774,17.24,0.08,0.31,0.218
"2356","45079",404869,46804,33,384596,9.9,32.8,38075,20273,8729,22.93,0.94,0.78,0.844
"2357","45081",20228,3689,40.6,19758,16.3,40.4,3221,470,468,14.53,-0.26,0.09,-0.05
"2358","45083",297732,45839,38.3,284540,13.6,38,38697,13192,7142,18.46,0.71,0.41,0.53
"2359","45085",107379,16185,36,107279,12.9,35.6,13839,100,2346,16.95,0.01,0.29,0.178
"2360","45087",27772,5298,43.7,28804,16.7,42.4,4810,-1032,488,10.15,-0.25,-0.27,-0.262
"2361","45089",32256,5941,41.7,34361,15,40.6,5154,-2105,787,15.27,-0.21,0.15,0.00599999999999999
"2362","45091",251664,33634,38.3,226576,11.4,37.2,25830,25088,7804,30.21,0.8,1.37,1.142
"2363","46003",2739,550,39.9,2726,18.4,41.7,502,13,48,9.56,-0.32,-0.32,-0.32
"2364","46005",18163,2991,37.9,17372,17.3,41,3005,791,-14,-0.47,-0.33,-1.14,-0.816
"2365","46007",3440,405,28.8,3432,11.9,27.8,408,8,-3,-0.74,-0.33,-1.16,-0.828
"2366","46009",6972,1444,43.5,7041,20,43.5,1408,-69,36,2.56,-0.32,-0.89,-0.662
"2367","46011",33697,3653,26.7,31973,10.1,26.1,3229,1724,424,13.13,-0.26,-0.03,-0.122
"2368","46013",38637,6253,37.3,36562,16.4,39.4,5996,2075,257,4.29,-0.29,-0.75,-0.566
"2369","46015",5280,900,40.5,5236,17.9,41.5,937,44,-37,-3.95,-0.33,-1.42,-0.984
"2370","46017",2048,160,25.3,1950,8.5,26.4,166,98,-6,-3.61,-0.33,-1.4,-0.972
"2371","46019",10194,1894,40.1,10122,16.3,40.1,1650,72,244,14.79,-0.29,0.11,-0.05
"2372","46021",1443,331,51.7,1419,26.4,50.5,375,24,-44,-11.73,-0.33,-2.06,-1.368
"2373","46023",9319,1687,36,9127,17.7,39,1615,192,72,4.46,-0.32,-0.74,-0.572
"2374","46025",3642,748,41.3,3653,21.6,45.4,789,-11,-41,-5.2,-0.33,-1.53,-1.05
"2375","46027",13907,1541,25,13966,10.2,25.5,1425,-59,116,8.14,-0.31,-0.43,-0.382
"2376","46029",27963,4488,38.3,27284,14.8,38.2,4038,679,450,11.14,-0.26,-0.19,-0.218
"2377","46031",4177,437,28.8,4046,10.9,29.8,441,131,-4,-0.91,-0.33,-1.18,-0.84
"2378","46033",8519,2291,53.8,8219,21.7,50.5,1784,300,507,28.42,-0.25,1.23,0.638
"2379","46035",19753,3449,38.2,19513,16.9,38.4,3298,240,151,4.58,-0.3,-0.73,-0.558
"2380","46037",5524,1378,48.4,5673,23.7,47.7,1345,-149,33,2.45,-0.32,-0.9,-0.668
"2381","46039",4282,904,44.7,4376,19.5,43.6,853,-94,51,5.98,-0.32,-0.61,-0.494
"2382","46041",5709,549,28,5358,9.6,29.1,514,351,35,6.81,-0.32,-0.54,-0.452
"2383","46043",2940,706,47.5,2992,24.2,48.1,724,-52,-18,-2.49,-0.33,-1.31,-0.918
"2384","46045",3971,815,44.4,4050,21.8,45.9,883,-79,-68,-7.7,-0.34,-1.73,-1.174
"2385","46047",6783,1736,50.9,7028,23.2,51.2,1630,-245,106,6.5,-0.31,-0.57,-0.466
"2386","46049",2327,562,48.1,2374,23,45.6,546,-47,16,2.93,-0.32,-0.86,-0.644
"2387","46051",7133,1429,43.7,7324,18.9,45,1384,-191,45,3.25,-0.32,-0.83,-0.626
"2388","46053",4209,1013,45.8,4251,24,48.4,1020,-42,-7,-0.69,-0.33,-1.16,-0.828
"2389","46055",2084,479,45.3,1852,21,48,389,232,90,23.14,-0.31,0.79,0.35
"2390","46057",5911,963,35.2,5875,17.2,37.4,1010,36,-47,-4.65,-0.33,-1.48,-1.02
"2391","46059",3303,826,47.4,3394,25.4,49.3,862,-91,-36,-4.18,-0.33,-1.44,-0.996
"2392","46061",3404,495,36.2,3366,13.9,35.6,468,38,27,5.77,-0.32,-0.63,-0.506
"2393","46063",1281,240,39.8,1367,13.5,40.6,185,-86,55,29.73,-0.32,1.33,0.67
"2394","46065",17572,2735,38.3,17064,13.7,40.6,2338,508,397,16.98,-0.27,0.29,0.066
"2395","46067",7277,1689,44.3,7283,25.5,46.9,1857,-6,-168,-9.05,-0.35,-1.84,-1.244
"2396","46069",1373,329,50,1437,22.8,42.6,328,-64,1,0.3,-0.33,-1.08,-0.78
"2397","46071",3275,464,31.6,3067,12.7,33.8,390,208,74,18.97,-0.31,0.45,0.146
"2398","46073",2034,527,48.6,2047,26.6,49.3,545,-13,-18,-3.3,-0.33,-1.37,-0.954
"2399","46075",740,169,53,1084,19.7,40.2,214,-344,-45,-21.03,-0.33,-2.82,-1.824
"2400","46077",5000,1109,46.8,5159,21.5,46.8,1109,-159,0,0,-0.33,-1.1,-0.792
"2401","46079",12350,2381,42,11364,17.2,41.2,1955,986,426,21.79,-0.26,0.68,0.304
"2402","46081",25018,4749,41.4,24063,16.9,41.2,4067,955,682,16.77,-0.23,0.27,0.07
"2403","46083",53147,5892,34.4,45055,9,33.2,4055,8092,1837,45.3,-0.06,2.61,1.542
"2404","46085",3882,588,36,3752,14.9,36.8,559,130,29,5.19,-0.32,-0.68,-0.536
"2405","46087",5515,1021,40.7,5592,19,42.4,1062,-77,-41,-3.86,-0.33,-1.42,-0.984
"2406","46089",2366,721,50.5,2485,28.7,50.1,713,-119,8,1.12,-0.32,-1.01,-0.734
"2407","46091",4759,953,41.3,4631,19,43,880,128,73,8.3,-0.32,-0.42,-0.38
"2408","46093",27066,3755,36.1,25456,12.2,36.1,3106,1610,649,20.9,-0.23,0.61,0.274
"2409","46095",2062,313,32.8,2057,12.7,31.5,261,5,52,19.92,-0.32,0.53,0.19
"2410","46097",2255,456,42,2365,22.6,47.1,534,-110,-78,-14.61,-0.34,-2.3,-1.516
"2411","46099",183660,22304,34.7,170342,11.1,34.7,18908,13318,3396,17.96,0.17,0.37,0.29
"2412","46101",6496,1134,40.3,6474,15.3,40.3,991,22,143,14.43,-0.3,0.08,-0.072
"2413","46102",14291,901,25.2,,,,,,,,,,
"2414","46103",108126,17255,37.8,101240,13.5,36.7,13667,6886,3588,26.25,0.19,1.05,0.706
"2415","46105",2964,641,47,2890,23.5,49.5,679,74,-38,-5.6,-0.33,-1.56,-1.068
"2416","46107",2318,662,52.6,2327,25,50.2,582,-9,80,13.75,-0.31,0.03,-0.106
"2417","46109",10250,1917,38.2,10158,17.3,39.7,1757,92,160,9.11,-0.3,-0.35,-0.33
"2418","46111",2366,464,45.3,2357,20.1,45.8,474,9,-10,-2.11,-0.33,-1.27,-0.894
"2419","46115",6478,1320,44.1,6483,19.9,44.2,1290,-5,30,2.33,-0.32,-0.91,-0.674
"2420","46117",2994,560,43.4,2940,17,43.5,500,54,60,12,-0.32,-0.12,-0.2
"2421","46119",1390,275,44.9,1382,20.5,47.2,283,8,-8,-2.83,-0.33,-1.33,-0.93
"2422","46121",10016,691,24.4,9711,5.7,22.9,554,305,137,24.73,-0.31,0.92,0.428
"2423","46123",5480,1170,46.5,5608,20.3,44,1138,-128,32,2.81,-0.32,-0.87,-0.65
"2424","46125",8242,1653,43.7,8344,19.2,43.7,1602,-102,51,3.18,-0.32,-0.84,-0.632
"2425","46127",14929,2475,41.1,14377,14.9,40.4,2142,552,333,15.55,-0.28,0.17,-0.01
"2426","46129",5502,1283,44.4,5443,23.7,46.8,1290,59,-7,-0.54,-0.33,-1.15,-0.822
"2427","46135",22660,3997,42.1,22434,16.2,41.1,3634,226,363,9.99,-0.27,-0.28,-0.276
"2428","46137",2837,248,30.5,2796,7.5,26.3,210,41,38,18.1,-0.32,0.38,0.1
"2429","47001",75538,14485,43.3,75039,17.3,42.4,12982,499,1503,11.58,-0.11,-0.15,-0.134
"2430","47003",46854,6820,37.2,45060,13.2,36.5,5948,1794,872,14.66,-0.2,0.1,-0.02
"2431","47005",16154,3729,46.5,16420,20.3,46,3333,-266,396,11.88,-0.27,-0.13,-0.186
"2432","47007",14413,2562,44.5,12898,15.5,42.2,1999,1515,563,28.16,-0.24,1.21,0.63
"2433","47009",127135,23986,43.2,123086,16.1,41.6,19817,4049,4169,21.04,0.28,0.62,0.484
"2434","47011",103666,16713,39.2,99229,14.3,38.3,14190,4437,2523,17.78,0.04,0.36,0.232
"2435","47013",39824,7905,43.5,40629,17.4,41.8,7069,-805,836,11.83,-0.2,-0.13,-0.158
"2436","47015",13839,2469,41.7,13797,16.1,40.4,2221,42,248,11.17,-0.29,-0.19,-0.23
"2437","47017",28137,5505,43,28486,17.9,42,5099,-349,406,7.96,-0.27,-0.45,-0.378
"2438","47019",56500,11439,44.4,57531,17.4,42.3,10010,-1031,1429,14.28,-0.12,0.07,-0.006
"2439","47021",39713,5473,40.5,39103,11.2,39.5,4380,610,1093,24.95,-0.17,0.94,0.496
"2440","47023",17097,2818,36.2,17043,15.1,37.6,2573,54,245,9.52,-0.29,-0.32,-0.308
"2441","47025",31566,5922,42.7,32025,16.1,41.5,5156,-459,766,14.86,-0.21,0.12,-0.012
"2442","47027",7684,1819,47.6,7842,21.2,45.1,1663,-158,156,9.38,-0.3,-0.33,-0.318
"2443","47029",35262,7060,44.7,35631,16.8,42.8,5986,-369,1074,17.94,-0.17,0.37,0.154
"2444","47031",54074,9171,40.2,52853,15.8,38.8,8351,1221,820,9.82,-0.21,-0.3,-0.264
"2445","47033",14554,2613,40,14567,16.5,40.3,2404,-13,209,8.69,-0.3,-0.39,-0.354
"2446","47035",58178,17169,50.5,56144,26.2,48.3,14710,2034,2459,16.72,0.03,0.27,0.174
"2447","47037",678322,77455,34.3,629113,10.5,33.9,66057,49209,11398,17.25,1.32,0.31,0.714
"2448","47039",11681,2647,45.7,11732,20.8,44.3,2440,-51,207,8.48,-0.3,-0.41,-0.366
"2449","47041",19380,3391,40.9,18770,15.7,40.2,2947,610,444,15.07,-0.26,0.13,-0.026
"2450","47043",51341,7814,39.5,49704,13.1,38.4,6511,1637,1303,20.01,-0.14,0.54,0.268
"2451","47045",37751,6238,40.5,38234,14.3,39.5,5467,-483,771,14.1,-0.21,0.05,-0.054
"2452","47047",39336,7599,44.8,38370,15.2,41.8,5832,966,1767,30.3,-0.07,1.38,0.8
"2453","47049",17940,3670,44.8,17945,17.3,42.4,3104,-5,566,18.23,-0.24,0.39,0.138
"2454","47051",41397,7775,41.5,40972,17.4,41.6,7129,425,646,9.06,-0.23,-0.36,-0.308
"2455","47053",49222,8614,40.3,49594,16.7,40.1,8282,-372,332,4.01,-0.28,-0.77,-0.574
"2456","47055",29024,5527,43.1,29439,16.9,42.2,4975,-415,552,11.1,-0.25,-0.19,-0.214
"2457","47057",22942,4407,44.2,22613,16,42.1,3618,329,789,21.81,-0.21,0.69,0.33
"2458","47059",68520,13886,44.3,68755,17.5,42.6,12032,-235,1854,15.41,-0.06,0.16,0.072
"2459","47061",13359,2704,43,13751,18,41.8,2475,-392,229,9.25,-0.29,-0.34,-0.32
"2460","47063",63465,11197,40.3,62528,16.1,39.1,10067,937,1130,11.22,-0.16,-0.18,-0.172
"2461","47065",354589,58334,39.5,337023,14.7,39.1,49542,17566,8792,17.75,0.95,0.35,0.59
"2462","47067",6605,1249,44.6,6759,17.1,42.3,1156,-154,93,8.04,-0.31,-0.44,-0.388
"2463","47069",25784,4435,40.5,27193,14.2,39.7,3861,-1409,574,14.87,-0.24,0.12,-0.024
"2464","47071",25813,5558,45.3,25987,18.8,42.9,4886,-174,672,13.75,-0.23,0.03,-0.074
"2465","47073",56402,10892,44.2,56725,16.9,42.3,9587,-323,1305,13.61,-0.14,0.01,-0.05
"2466","47075",17944,2985,40,18673,14.1,39.9,2633,-729,352,13.37,-0.27,-0.01,-0.114
"2467","47077",27889,4794,41.2,27835,14.8,39.5,4120,54,674,16.36,-0.23,0.24,0.052
"2468","47079",32263,7120,45.3,32271,19.7,44.1,6357,-8,763,12,-0.22,-0.12,-0.16
"2469","47081",24502,3957,40.9,24481,13.9,40.4,3403,21,554,16.28,-0.25,0.23,0.038
"2470","47083",8188,1660,43.6,8375,17.9,41.3,1499,-187,161,10.74,-0.3,-0.22,-0.252
"2471","47085",18281,3502,42.1,18428,17.2,40.7,3170,-147,332,10.47,-0.28,-0.24,-0.256
"2472","47087",11573,2479,46.9,11526,17.7,44.5,2040,47,439,21.52,-0.26,0.66,0.292
"2473","47089",52887,10083,43.2,51541,16.3,40.5,8401,1346,1682,20.02,-0.08,0.54,0.292
"2474","47091",17846,3822,45.7,18199,18.1,43.5,3294,-353,528,16.03,-0.25,0.21,0.026
"2475","47093",452286,66797,37.3,433207,13.2,37.2,57183,19079,9614,16.81,1.07,0.28,0.596
"2476","47095",7588,1179,40.2,7780,13.8,39.7,1074,-192,105,9.78,-0.31,-0.3,-0.304
"2477","47097",26497,3938,38,27772,12.4,36.2,3444,-1275,494,14.34,-0.25,0.07,-0.058
"2478","47099",42591,7467,39.6,41779,16,39.8,6685,812,782,11.7,-0.21,-0.14,-0.168
"2479","47101",11944,2491,44.7,12050,16.6,41.1,2000,-106,491,24.55,-0.25,0.91,0.446
"2480","47103",33543,6288,43.3,33295,16.8,41.9,5594,248,694,12.41,-0.23,-0.08,-0.14
"2481","47105",51024,12760,47.1,48586,21.6,45.9,10495,2438,2265,21.58,0,0.67,0.402
"2482","47107",52569,9926,42.6,52325,17,41,8895,244,1031,11.59,-0.18,-0.15,-0.162
"2483","47109",25945,5146,42.7,26001,17.6,42,4576,-56,570,12.46,-0.24,-0.08,-0.144
"2484","47111",23239,3615,38.6,22265,13.9,38.3,3095,974,520,16.8,-0.25,0.28,0.068
"2485","47113",97887,15129,37.9,97976,13.2,36.8,12933,-89,2196,16.98,-0.01,0.29,0.17
"2486","47115",28355,5327,43.2,28184,16,42.3,4509,171,818,18.14,-0.21,0.38,0.144
"2487","47117",31753,4862,39.3,30585,13.2,39.3,4037,1168,825,20.44,-0.21,0.57,0.258
"2488","47119",87606,13137,38.9,80965,13.1,37.9,10606,6641,2531,23.86,0.04,0.85,0.526
"2489","47121",11830,2335,44.4,11696,16.7,43.2,1953,134,382,19.56,-0.27,0.5,0.192
"2490","47123",45698,8952,43,44680,16.5,41.5,7372,1018,1580,21.43,-0.1,0.65,0.35
"2491","47125",192120,16714,30.5,173138,8,30.2,13851,18982,2863,20.67,0.09,0.59,0.39
"2492","47127",6302,1327,45.1,6349,18.8,43.2,1194,-47,133,11.14,-0.31,-0.19,-0.238
"2493","47129",21639,3478,41.2,21882,14.2,40,3107,-243,371,11.94,-0.27,-0.12,-0.18
"2494","47131",30659,5897,42.6,31721,16.8,41.2,5329,-1062,568,10.66,-0.24,-0.23,-0.234
"2495","47133",21995,4261,42.6,22040,17.1,41.3,3769,-45,492,13.05,-0.25,-0.03,-0.118
"2496","47135",7882,1593,43.5,7856,18.4,43.1,1446,26,147,10.17,-0.3,-0.27,-0.282
"2497","47137",5071,1327,49.8,5108,22.6,47.3,1154,-37,173,14.99,-0.3,0.13,-0.042
"2498","47139",16722,3303,44.9,16756,17.4,42.5,2916,-34,387,13.27,-0.27,-0.01,-0.114
"2499","47141",75565,12301,36,72172,14.8,35.9,10681,3393,1620,15.17,-0.09,0.14,0.048
"2500","47143",32478,5790,40.7,31817,15.7,40,4995,661,795,15.92,-0.21,0.2,0.036
"2501","47145",52926,11531,46.5,54027,18.7,44.9,10103,-1101,1428,14.13,-0.12,0.06,-0.012
"2502","47147",68575,9396,38.7,66143,11.9,37.7,7871,2432,1525,19.37,-0.1,0.49,0.254
"2503","47149",298456,28873,33.1,263815,8.4,32.4,22160,34641,6713,30.29,0.65,1.38,1.088
"2504","47151",21949,3477,38.7,22196,13.9,37.9,3085,-247,392,12.71,-0.27,-0.06,-0.144
"2505","47153",14654,2758,43,14173,16.2,40.6,2296,481,462,20.12,-0.26,0.55,0.226
"2506","47155",95523,17260,42.4,90218,15.5,41.2,13984,5305,3276,23.43,0.15,0.82,0.552
"2507","47157",937847,114417,35.3,929437,10.3,34.5,95732,8410,18685,19.52,2.38,0.5,1.252
"2508","47159",19279,3059,41.2,19157,13.9,40.2,2663,122,396,14.87,-0.27,0.12,-0.036
"2509","47161",13248,2557,43.6,13262,16.8,42.8,2228,-14,329,14.77,-0.28,0.11,-0.046
"2510","47163",156519,32363,44.7,156675,18.7,43.5,29298,-156,3065,10.46,0.12,-0.24,-0.096
"2511","47165",175730,26026,39.6,161206,12.9,38.7,20796,14524,5230,25.15,0.43,0.96,0.748
"2512","47167",61434,8210,37.3,61038,11.2,37.2,6836,396,1374,20.1,-0.13,0.55,0.278
"2513","47169",8773,1361,37.5,7827,13,38,1018,946,343,33.69,-0.28,1.66,0.884
"2514","47171",17830,3952,45.9,18287,19.6,44.7,3584,-457,368,10.27,-0.27,-0.26,-0.264
"2515","47173",19176,3252,42,19179,14,40.1,2685,-3,567,21.12,-0.24,0.63,0.282
"2516","47175",5675,1217,47.2,5552,17.3,43.5,960,123,257,26.77,-0.29,1.09,0.538
"2517","47177",40210,6772,40.1,39767,15.3,38.7,6084,443,688,11.31,-0.23,-0.17,-0.194
"2518","47179",126437,21607,39.8,122840,15.2,39.6,18672,3597,2935,15.72,0.1,0.19,0.154
"2519","47181",16713,3036,41.9,17015,16,41.7,2722,-302,314,11.54,-0.28,-0.16,-0.208
"2520","47183",33776,5796,38.1,34802,15.1,36.8,5255,-1026,541,10.29,-0.25,-0.26,-0.256
"2521","47185",26394,5177,43.4,25863,17.5,41.4,4526,531,651,14.38,-0.23,0.08,-0.044
"2522","47187",212161,25459,39,184225,9.9,38.5,18238,27936,7221,39.59,0.72,2.14,1.572
"2523","47189",128874,19008,40.2,114618,12.4,39.3,14213,14256,4795,33.74,0.37,1.66,1.144
"2524","48001",57747,8134,39.1,58269,12.9,38.8,7517,-522,617,8.21,-0.24,-0.43,-0.354
"2525","48003",17577,1788,31.6,15006,11,33.8,1651,2571,137,8.3,-0.31,-0.42,-0.376
"2526","48005",87700,13385,36.8,86550,13.7,36.2,11857,1150,1528,12.89,-0.1,-0.05,-0.07
"2527","48007",24832,6427,49.6,23391,24.3,48.3,5684,1441,743,13.07,-0.22,-0.03,-0.106
"2528","48009",8793,1647,44.8,8944,16.5,42.9,1476,-151,171,11.59,-0.3,-0.15,-0.21
"2529","48011",1929,401,45.9,1820,23.4,44.8,426,109,-25,-5.87,-0.33,-1.58,-1.08
"2530","48013",48139,6696,35.4,45091,12.8,35.8,5772,3048,924,16.01,-0.19,0.21,0.05
"2531","48015",29292,5281,40.9,28372,16.1,40.4,4568,920,713,15.61,-0.22,0.18,0.02
"2532","48017",7098,1013,35.2,7096,14.1,33.9,1001,2,12,1.2,-0.32,-1,-0.728
"2533","48019",21316,5433,52,20477,20.3,48.5,4157,839,1276,30.7,-0.14,1.41,0.79
"2534","48021",80306,11115,38.8,74023,11.7,38.3,8661,6283,2454,28.33,0.03,1.22,0.744
"2535","48023",3602,861,48.1,3706,26.9,50.2,997,-104,-136,-13.64,-0.35,-2.22,-1.472
"2536","48025",32729,3843,35.2,32083,10.7,35.4,3433,646,410,11.94,-0.27,-0.12,-0.18
"2537","48027",336506,33740,30.6,310155,8.8,29.7,27294,26351,6446,23.62,0.61,0.83,0.742
"2538","48029",1892004,215795,33.3,1719902,10.4,32.9,178870,172102,36925,20.64,5.02,0.59,2.362
"2539","48031",11089,2625,49.5,10425,18.7,46.1,1949,664,676,34.68,-0.23,1.74,0.952
"2540","48033",602,142,42.1,642,21.8,40,140,-40,2,1.43,-0.33,-0.98,-0.72
"2541","48035",17955,4324,46.5,18114,21.6,45.6,3913,-159,411,10.5,-0.27,-0.24,-0.252
"2542","48037",93635,14813,38.2,92460,14.3,37.6,13222,1175,1591,12.03,-0.1,-0.12,-0.112
"2543","48039",345995,38356,35.6,313813,9.7,35.2,30440,32182,7916,26.01,0.82,1.03,0.946
"2544","48041",214231,18110,25.8,194087,7.3,24.5,14168,20144,3942,27.82,0.25,1.18,0.808
"2545","48043",9220,1863,43.1,9175,16.8,40.6,1541,45,322,20.9,-0.28,0.61,0.254
"2546","48045",1591,368,46.4,1674,22.4,43.9,375,-83,-7,-1.87,-0.33,-1.25,-0.882
"2547","48047",7251,1073,31.8,7236,17.5,32,1266,15,-193,-15.24,-0.35,-2.35,-1.55
"2548","48049",37787,7250,41,38018,17.4,39.6,6615,-231,635,9.6,-0.23,-0.31,-0.278
"2549","48051",17596,3537,42.9,17160,17.9,41.6,3072,436,465,15.14,-0.26,0.14,-0.02
"2550","48053",45017,9666,44,42946,19.1,44,8203,2071,1463,17.83,-0.11,0.36,0.172
"2551","48055",40544,5362,35.8,38152,12.2,35.1,4655,2392,707,15.19,-0.22,0.14,-0.004
"2552","48057",21821,3609,37.7,21366,15.3,38.2,3269,455,340,10.4,-0.28,-0.25,-0.262
"2553","48059",13660,2662,43.3,13521,18.4,42.2,2488,139,174,6.99,-0.3,-0.53,-0.438
"2554","48061",420201,52630,31.4,405819,11.2,30.6,45452,14382,7178,15.79,0.71,0.19,0.398
"2555","48063",12670,2254,36.8,12389,16.7,38,2069,281,185,8.94,-0.3,-0.37,-0.342
"2556","48065",6033,1047,41.1,6215,16.8,40.6,1044,-182,3,0.29,-0.33,-1.08,-0.78
"2557","48067",30118,6338,42.9,30324,19.4,43.8,5883,-206,455,7.73,-0.26,-0.47,-0.386
"2558","48069",7891,1142,34.4,7984,13.6,33.8,1086,-93,56,5.16,-0.32,-0.68,-0.536
"2559","48071",39283,4193,35.4,34562,9.5,36.2,3283,4721,910,27.72,-0.19,1.17,0.626
"2560","48073",51594,8657,38,50690,14.8,37.7,7502,904,1155,15.4,-0.16,0.16,0.032
"2561","48075",7064,1072,32.8,7047,13.8,35.2,972,17,100,10.29,-0.31,-0.26,-0.28
"2562","48077",10369,2214,46,10718,17.8,44.8,1908,-349,306,16.04,-0.28,0.21,0.014
"2563","48079",2932,438,33.5,3087,13.7,34.2,423,-155,15,3.55,-0.32,-0.81,-0.614
"2564","48081",3238,864,49.1,3298,25.6,48.6,844,-60,20,2.37,-0.32,-0.91,-0.674
"2565","48083",8422,1872,46.6,8817,21.4,45.8,1887,-395,-15,-0.79,-0.33,-1.17,-0.834
"2566","48085",914075,92047,36.5,788580,7.9,35.1,62298,125495,29749,47.75,3.98,2.81,3.278
"2567","48087",3026,557,39.8,3050,20.2,36.7,616,-24,-59,-9.58,-0.33,-1.89,-1.266
"2568","48089",20913,4175,43.4,20784,19.5,43.1,4053,129,122,3.01,-0.31,-0.85,-0.634
"2569","48091",129100,22615,42.2,108985,15.6,42.7,17002,20115,5613,33.01,0.49,1.6,1.156
"2570","48093",13492,3213,44.4,13875,21.1,43.4,2928,-383,285,9.73,-0.28,-0.3,-0.292
"2571","48095",3858,667,41.9,4073,14.3,40.9,582,-215,85,14.6,-0.31,0.09,-0.07
"2572","48097",39064,6979,40.5,38427,16,38.8,6148,637,831,13.52,-0.21,0.01,-0.078
"2573","48099",75818,6943,31.2,75728,7.6,29.9,5755,90,1188,20.64,-0.15,0.59,0.294
"2574","48101",1498,384,47.6,1600,26.6,49.4,426,-102,-42,-9.86,-0.33,-1.91,-1.278
"2575","48103",4836,552,32.1,4359,12.8,38,558,477,-6,-1.08,-0.33,-1.19,-0.846
"2576","48105",3836,543,35.5,3669,14.9,38.1,547,167,-4,-0.73,-0.33,-1.16,-0.828
"2577","48107",5895,1015,37.7,6100,17.1,37.6,1043,-205,-28,-2.68,-0.33,-1.32,-0.924
"2578","48109",2257,444,41.2,2386,10.2,38.1,243,-129,201,82.72,-0.3,5.68,3.288
"2579","48111",7207,775,32.1,6734,8,31.4,539,473,236,43.78,-0.29,2.49,1.378
"2580","48113",2552213,255384,33.3,2379214,8.8,32.5,209371,172999,46013,21.98,6.34,0.7,2.956
"2581","48115",13095,1892,33.1,13761,14.4,33.4,1982,-666,-90,-4.54,-0.34,-1.47,-1.018
"2582","48117",18947,2269,31.8,19275,11.4,31.1,2197,-328,72,3.28,-0.32,-0.83,-0.626
"2583","48119",5172,1028,43.7,5240,20.1,43.6,1053,-68,-25,-2.37,-0.33,-1.3,-0.912
"2584","48121",781321,71591,34.9,667934,7.1,33,47423,113387,24168,50.96,3.17,3.07,3.11
"2585","48123",20474,3860,41.2,20156,18.7,42.7,3769,318,91,2.41,-0.31,-0.9,-0.664
"2586","48125",2224,502,43.2,2399,18.4,45.4,441,-175,61,13.83,-0.32,0.03,-0.11
"2587","48127",10822,1593,33.5,10054,14.8,37,1488,768,105,7.06,-0.31,-0.52,-0.436
"2588","48129",3433,803,41.9,3652,21.2,40.7,774,-219,29,3.75,-0.32,-0.79,-0.602
"2589","48131",11434,2060,36.8,11821,16.4,37.2,1939,-387,121,6.24,-0.31,-0.59,-0.478
"2590","48133",18278,3994,43,18519,20.2,41.2,3741,-241,253,6.76,-0.29,-0.55,-0.446
"2591","48135",155744,14793,30.3,138193,10.1,31.2,13957,17551,836,5.99,-0.2,-0.61,-0.446
"2592","48137",2111,601,49.1,2023,20.9,45.1,423,88,178,42.08,-0.3,2.35,1.29
"2593","48139",164092,19756,36,149712,10.2,35,15271,14380,4485,29.37,0.32,1.31,0.914
"2594","48141",834825,95067,31.9,801115,10.3,31.2,82515,33710,12552,15.21,1.49,0.14,0.68
"2595","48143",41016,5666,30,38192,12.5,30.9,4774,2824,892,18.68,-0.2,0.43,0.178
"2596","48145",17289,2935,39.2,17756,15.8,39,2805,-467,130,4.63,-0.31,-0.72,-0.556
"2597","48147",33787,6359,41.9,33867,17.2,40.4,5825,-80,534,9.17,-0.25,-0.35,-0.31
"2598","48149",24963,5923,47.2,24557,22,47.2,5403,406,520,9.62,-0.25,-0.31,-0.286
"2599","48151",3875,910,44,3963,21.8,42.1,864,-88,46,5.32,-0.32,-0.67,-0.53
"2600","48153",5953,1101,37.1,6439,17.6,38.2,1133,-486,-32,-2.82,-0.33,-1.33,-0.93
"2601","48155",1414,376,48.6,1273,24.4,44.4,311,141,65,20.9,-0.32,0.61,0.238
"2602","48157",711421,69049,35.8,587666,7.6,35.1,44663,123755,24386,54.6,3.21,3.37,3.306
"2603","48159",10639,2127,42.9,10593,19,42.5,2013,46,114,5.66,-0.31,-0.64,-0.508
"2604","48161",19646,3724,40.6,19631,16.8,41.4,3298,15,426,12.92,-0.26,-0.04,-0.128
"2605","48163",19110,2355,31.3,17265,11.9,31.8,2055,1845,300,14.6,-0.28,0.09,-0.058
"2606","48165",19889,1713,28.1,17572,9.3,29.2,1634,2317,79,4.83,-0.31,-0.71,-0.55
"2607","48167",321184,42256,37.6,292874,11.4,37.3,33388,28310,8868,26.56,0.96,1.07,1.026
"2608","48169",6739,761,40.1,6295,12.6,38.4,793,444,-32,-4.04,-0.33,-1.43,-0.99
"2609","48171",25939,7434,50.2,24777,26.6,49.8,6591,1162,843,12.79,-0.2,-0.05,-0.11
"2610","48173",1420,198,38.3,1255,11.2,39.8,141,165,57,40.43,-0.32,2.21,1.198
"2611","48175",7510,1577,46.4,7223,19.4,44.6,1401,287,176,12.56,-0.3,-0.07,-0.162
"2612","48177",20558,3279,36.9,19773,15.8,36.9,3124,785,155,4.96,-0.3,-0.69,-0.534
"2613","48179",22962,3617,36.7,22731,15.9,38.4,3614,231,3,0.08,-0.33,-1.09,-0.786
"2614","48181",126146,21713,40.2,120641,15.6,39.4,18820,5505,2893,15.37,0.09,0.16,0.132
"2615","48183",123402,17844,35.4,121451,13.5,35.4,16396,1951,1448,8.83,-0.12,-0.38,-0.276
"2616","48185",27358,4376,40.4,26564,14.3,39.1,3799,794,577,15.19,-0.24,0.14,-0.012
"2617","48187",150889,19710,36.7,131945,11.8,36.5,15570,18944,4140,26.59,0.27,1.08,0.756
"2618","48189",34527,4468,33,36153,12.2,32.4,4411,-1626,57,1.29,-0.32,-1,-0.728
"2619","48191",3102,703,43.2,3337,22.2,43.5,741,-235,-38,-5.13,-0.33,-1.52,-1.044
"2620","48193",8220,2084,46.4,8448,24.6,46.6,2078,-228,6,0.29,-0.32,-1.08,-0.776
"2621","48195",5532,858,34.9,5556,13.9,36.5,772,-24,86,11.14,-0.31,-0.19,-0.238
"2622","48197",3990,799,43.6,4124,19.7,42.3,812,-134,-13,-1.6,-0.33,-1.23,-0.87
"2623","48199",55993,8825,39.3,54497,13.7,38.4,7466,1496,1359,18.2,-0.13,0.39,0.182
"2624","48201",4525519,432729,33.1,4101752,8.3,32.2,340445,423767,92284,27.11,13.04,1.12,5.888
"2625","48203",66606,10396,37.7,65958,13.5,37,8904,648,1492,16.76,-0.11,0.27,0.118
"2626","48205",5821,810,39.8,6015,13.2,39.2,794,-194,16,2.02,-0.32,-0.94,-0.692
"2627","48207",5806,1229,43.4,5891,22.1,43.5,1302,-85,-73,-5.61,-0.34,-1.56,-1.072
"2628","48209",194843,19839,31.3,158464,8.6,30.4,13628,36379,6211,45.58,0.57,2.63,1.806
"2629","48211",4152,515,35.1,3863,14.1,36.3,545,289,-30,-5.5,-0.33,-1.55,-1.062
"2630","48213",79687,16948,43.8,78558,19.2,42.7,15083,1129,1865,12.36,-0.06,-0.09,-0.078
"2631","48215",839539,87567,28.9,774820,9.5,28.3,73608,64719,13959,18.96,1.7,0.45,0.95
"2632","48217",35098,7097,42.5,35079,18.4,41.2,6455,19,642,9.95,-0.23,-0.29,-0.266
"2633","48219",23273,3143,33.4,22988,12.9,32.9,2965,285,178,6,-0.3,-0.61,-0.486
"2634","48221",55418,13310,46.8,51161,21.3,46.2,10897,4257,2413,22.14,0.02,0.71,0.434
"2635","48223",35929,6321,39.6,35088,15.8,39.1,5544,841,777,14.02,-0.21,0.05,-0.054
"2636","48225",22849,4772,44.6,23512,19.5,44,4585,-663,187,4.08,-0.3,-0.77,-0.582
"2637","48227",36491,4572,36.7,34927,13.3,37.5,4645,1564,-73,-1.57,-0.34,-1.23,-0.874
"2638","48229",3702,603,38.8,3407,14.1,36.1,480,295,123,25.62,-0.31,1,0.476
"2639","48231",90322,14099,37.9,85955,14,37.6,12034,4367,2065,17.16,-0.03,0.3,0.168
"2640","48233",21704,3326,36.9,21992,14.9,37.2,3277,-288,49,1.5,-0.32,-0.98,-0.716
"2641","48235",1592,281,45.5,1596,13.3,39.3,212,-4,69,32.55,-0.32,1.57,0.814
"2642","48237",8839,1417,40.6,9027,14.9,39.4,1345,-188,72,5.35,-0.32,-0.66,-0.524
"2643","48239",14756,2448,39.2,14075,16.3,39,2294,681,154,6.71,-0.3,-0.55,-0.45
"2644","48241",35444,6538,40.4,35703,16.6,40.3,5927,-259,611,10.31,-0.24,-0.26,-0.252
"2645","48243",2236,698,55.3,2319,27.6,50.2,640,-83,58,9.06,-0.32,-0.36,-0.344
"2646","48245",254574,34839,36,251627,12.8,36,32208,2947,2631,8.17,0.06,-0.43,-0.234
"2647","48247",5262,979,35.4,5257,15.4,38.3,810,5,169,20.86,-0.3,0.61,0.246
"2648","48249",41318,5908,34.5,41014,13.1,34.5,5373,304,535,9.96,-0.25,-0.29,-0.274
"2649","48251",160173,21591,36.9,151174,11.6,36.2,17536,8999,4055,23.12,0.26,0.79,0.578
"2650","48253",19969,2927,38.6,20137,13.6,39.5,2739,-168,188,6.86,-0.3,-0.54,-0.444
"2651","48255",15051,2150,35.3,14936,14.1,36.9,2106,115,44,2.09,-0.32,-0.93,-0.686
"2652","48257",114852,13514,35.7,103385,10.5,35.3,10855,11467,2659,24.5,0.06,0.91,0.57
"2653","48259",40306,7479,42.4,33745,16.7,43.1,5635,6561,1844,32.72,-0.06,1.58,0.924
"2654","48261",564,83,29.8,451,21.5,45.1,97,113,-14,-14.43,-0.33,-2.28,-1.5
"2655","48263",680,190,46.7,829,24.1,45.6,200,-149,-10,-5,-0.33,-1.51,-1.038
"2656","48265",50761,13540,47.8,49469,25.1,47.3,12417,1292,1123,9.04,-0.16,-0.36,-0.28
"2657","48267",4432,1332,52.6,4577,24.8,51.3,1135,-145,197,17.36,-0.3,0.32,0.072
"2658","48269",289,21,32.7,227,18.1,53.9,41,62,-20,-48.78,-0.33,-5.1,-3.192
"2659","48271",3631,639,41.1,3574,19.1,46.4,683,57,-44,-6.44,-0.33,-1.63,-1.11
"2660","48273",31540,4018,27.9,31925,11.4,28.7,3639,-385,379,10.41,-0.27,-0.25,-0.258
"2661","48275",3753,690,40.6,3713,21.4,41.4,795,40,-105,-13.21,-0.34,-2.18,-1.444
"2662","48277",49401,9092,40.4,49740,16.8,40.1,8356,-339,736,8.81,-0.22,-0.38,-0.316
"2663","48279",13368,2134,35.6,13996,16,36.1,2239,-628,-105,-4.69,-0.34,-1.49,-1.03
"2664","48281",20473,3631,41.8,19837,16.1,40.3,3194,636,437,13.68,-0.26,0.02,-0.092
"2665","48283",7418,1161,33.9,6850,13.3,33.9,911,568,250,27.44,-0.29,1.15,0.574
"2666","48285",19859,4463,43.9,19269,21,45.2,4046,590,417,10.31,-0.27,-0.26,-0.264
"2667","48287",16850,2914,41.3,16591,16.3,40.7,2704,259,210,7.77,-0.3,-0.46,-0.396
"2668","48289",16966,3979,44.7,16827,21.3,45,3584,139,395,11.02,-0.27,-0.2,-0.228
"2669","48291",79884,10220,35.8,75662,11.2,36.1,8474,4222,1746,20.6,-0.07,0.59,0.326
"2670","48293",23480,4175,39.5,23350,16.1,38.9,3759,130,416,11.07,-0.27,-0.19,-0.222
"2671","48295",3495,521,35,3324,13.8,36.3,459,171,62,13.51,-0.32,0.01,-0.122
"2672","48297",12043,2388,42.3,11526,19.3,42.8,2225,517,163,7.33,-0.3,-0.5,-0.42
"2673","48299",20195,7162,57.1,19115,31.7,55.3,6059,1080,1103,18.2,-0.17,0.39,0.166
"2674","48301",74,18,57.5,85,5.9,47,5,-11,13,260,-0.32,20.2,11.992
"2675","48303",298042,35225,30.7,278339,11.1,30.4,30896,19703,4329,14.01,0.3,0.05,0.15
"2676","48305",5785,972,38.1,5886,15.7,40.6,924,-101,48,5.19,-0.32,-0.68,-0.536
"2677","48307",8145,1736,43.5,8281,18.5,40.8,1532,-136,204,13.32,-0.3,-0.01,-0.126
"2678","48309",245720,33503,33.2,234626,12.5,32.8,29328,11094,4175,14.24,0.28,0.07,0.154
"2679","48311",600,159,42,696,22.7,41.9,158,-96,1,0.63,-0.33,-1.05,-0.762
"2680","48313",13979,2101,35.2,13590,13.9,34.3,1889,389,212,11.22,-0.29,-0.18,-0.224
"2681","48315",10140,2487,49.8,10544,22.2,48.8,2341,-404,146,6.24,-0.3,-0.59,-0.474
"2682","48317",5547,673,31.7,4804,13,35.1,625,743,48,7.68,-0.32,-0.47,-0.41
"2683","48319",4122,1068,48.9,3978,27.6,49.8,1098,144,-30,-2.73,-0.33,-1.32,-0.924
"2684","48321",36744,5766,37.2,36653,14.3,38.1,5241,91,525,10.02,-0.25,-0.28,-0.268
"2685","48323",57471,6426,29.6,54107,10.8,30.1,5844,3364,582,9.96,-0.24,-0.29,-0.27
"2686","48325",48548,7702,38.8,46009,13.5,37.9,6211,2539,1491,24.01,-0.11,0.87,0.478
"2687","48327",2123,578,49.1,2232,22.7,43.7,507,-109,71,14,-0.32,0.05,-0.098
"2688","48329",159883,16386,31.8,138472,10.9,33.3,15093,21411,1293,8.57,-0.14,-0.4,-0.296
"2689","48331",24479,4792,41.5,24691,17.6,40.6,4346,-212,446,10.26,-0.26,-0.26,-0.26
"2690","48333",4887,1344,47.3,4880,22.1,47.2,1078,7,266,24.68,-0.29,0.92,0.436
"2691","48335",8774,1265,34.6,9367,13.6,35.4,1274,-593,-9,-0.71,-0.33,-1.16,-0.828
"2692","48337",19406,4288,44,19737,20.1,42.6,3967,-331,321,8.09,-0.28,-0.44,-0.376
"2693","48339",535187,65963,36.7,458339,10.5,36.2,48126,76848,17837,37.06,2.26,1.94,2.068
"2694","48341",22016,2161,30.5,21765,9.7,30.8,2111,251,50,2.37,-0.32,-0.91,-0.674
"2695","48343",12530,2612,42.9,12914,20,43,2583,-384,29,1.12,-0.32,-1.01,-0.734
"2696","48345",1114,321,37.6,1153,23.2,43,267,-39,54,20.22,-0.32,0.56,0.208
"2697","48347",65411,8628,30.6,64647,11.9,29.7,7693,764,935,12.15,-0.19,-0.11,-0.142
"2698","48349",48239,7922,38.9,47739,14.4,37.1,6874,500,1048,15.25,-0.17,0.15,0.022
"2699","48351",14187,2705,43.5,14372,16.6,40.4,2386,-185,319,13.37,-0.28,-0.01,-0.118
"2700","48353",14990,2630,38.8,15104,16.2,38.2,2447,-114,183,7.48,-0.3,-0.49,-0.414
"2701","48355",358484,47851,35.1,340568,12.1,35,41209,17916,6642,16.12,0.64,0.22,0.388
"2702","48357",10484,1054,31.7,10314,10.7,31.1,1104,170,-50,-4.53,-0.33,-1.47,-1.014
"2703","48359",2083,287,29.9,2048,15.3,39.3,313,35,-26,-8.31,-0.33,-1.78,-1.2
"2704","48361",83909,12566,37.7,82306,14,38.7,11523,1603,1043,9.05,-0.17,-0.36,-0.284
"2705","48363",28109,5260,41,28010,16.5,40.3,4622,99,638,13.8,-0.23,0.03,-0.074
"2706","48365",23574,4072,38.7,23814,15.7,39.3,3739,-240,333,8.91,-0.28,-0.37,-0.334
"2707","48367",125963,18674,39.6,116820,12.5,38.9,14602,9143,4072,27.89,0.26,1.18,0.812
"2708","48369",9871,1294,34.1,10172,12.2,32.2,1241,-301,53,4.27,-0.32,-0.75,-0.578
"2709","48371",15804,1979,36.2,15510,12,36.1,1861,294,118,6.34,-0.31,-0.58,-0.472
"2710","48373",46974,8817,43.4,45618,19.1,43.2,8713,1356,104,1.19,-0.31,-1,-0.724
"2711","48375",121230,14090,33.6,121099,10.9,32.8,13200,131,890,6.74,-0.2,-0.55,-0.41
"2712","48377",7191,1573,41.4,7678,18.5,39,1420,-487,153,10.77,-0.3,-0.22,-0.252
"2713","48379",11246,2642,47.6,10976,20.8,45.9,2283,270,359,15.72,-0.27,0.19,0.00599999999999998
"2714","48381",130552,18129,35.6,121090,12.5,35.3,15136,9462,2993,19.77,0.11,0.52,0.356
"2715","48383",3735,413,33,3384,10.1,34.4,342,351,71,20.76,-0.32,0.6,0.232
"2716","48385",3358,1145,54.3,3326,32.5,51.8,1081,32,64,5.92,-0.32,-0.62,-0.5
"2717","48387",12353,2874,45.6,12795,21.1,44.5,2700,-442,174,6.44,-0.3,-0.57,-0.462
"2718","48389",14791,1896,35.4,13606,15.1,36.4,2055,1185,-159,-7.74,-0.35,-1.74,-1.184
"2719","48391",7293,1536,42.3,7352,19.5,43.7,1434,-59,102,7.11,-0.31,-0.52,-0.436
"2720","48393",889,184,37.8,992,14.7,41.9,146,-103,38,26.03,-0.32,1.03,0.49
"2721","48395",16727,3028,41.4,16596,17.5,40.7,2904,131,124,4.27,-0.31,-0.75,-0.574
"2722","48397",90414,10576,37.2,78749,9.7,35.8,7639,11665,2937,38.45,0.1,2.05,1.27
"2723","48399",10266,2094,41.1,10473,19.7,43.1,2063,-207,31,1.5,-0.32,-0.98,-0.716
"2724","48401",53026,8412,38.5,53211,14.5,39.3,7716,-185,696,9.02,-0.22,-0.36,-0.304
"2725","48403",10429,3119,52.1,10642,26.8,50.2,2852,-213,267,9.36,-0.29,-0.33,-0.314
"2726","48405",8403,2057,48.9,8898,23.4,47.6,2082,-495,-25,-1.2,-0.33,-1.2,-0.852
"2727","48407",27436,5582,44.2,26482,17.3,43,4581,954,1001,21.85,-0.18,0.69,0.342
"2728","48409",66867,9434,35.1,65352,12.8,35.8,8365,1515,1069,12.78,-0.17,-0.05,-0.098
"2729","48411",5851,1284,40.9,6037,20.4,41.7,1232,-186,52,4.22,-0.32,-0.76,-0.584
"2730","48413",3122,503,35.2,3327,13.9,36.1,462,-205,41,8.87,-0.32,-0.37,-0.35
"2731","48415",17346,2539,35.6,16855,13.9,37.2,2343,491,196,8.37,-0.3,-0.42,-0.372
"2732","48417",3348,606,42,3346,17.9,43.1,599,2,7,1.17,-0.32,-1.01,-0.734
"2733","48419",25689,4228,37.4,25602,15.4,37.9,3943,87,285,7.23,-0.28,-0.51,-0.418
"2734","48421",3067,429,39.8,3040,12.7,35.4,386,27,43,11.14,-0.32,-0.19,-0.242
"2735","48423",222277,34654,36.6,209691,14.4,35.8,30196,12586,4458,14.76,0.32,0.11,0.194
"2736","48425",8650,1578,40.6,8444,14.7,39.4,1241,206,337,27.16,-0.28,1.12,0.56
"2737","48427",63420,7023,28.8,60882,10.5,29,6393,2538,630,9.85,-0.23,-0.29,-0.266
"2738","48429",9365,1779,39.2,9561,18.6,40.5,1778,-196,1,0.06,-0.33,-1.1,-0.792
"2739","48431",1139,182,42.4,1223,14.7,43.5,180,-84,2,1.11,-0.33,-1.01,-0.738
"2740","48433",1084,283,51.9,1447,22.9,45.8,331,-363,-48,-14.5,-0.33,-2.29,-1.506
"2741","48435",3894,655,40.2,4123,12.4,35.3,511,-229,144,28.18,-0.3,1.21,0.606
"2742","48437",7541,1330,35.6,7816,16.9,36.4,1321,-275,9,0.68,-0.32,-1.05,-0.758
"2743","48439",1983675,208089,34.2,1814667,9,33.4,163320,169008,44769,27.41,6.16,1.14,3.148
"2744","48441",135371,18871,32.2,131425,13.3,32.6,17480,3946,1391,7.96,-0.12,-0.45,-0.318
"2745","48443",721,225,47.3,1001,24.3,47.1,243,-280,-18,-7.41,-0.33,-1.71,-1.158
"2746","48445",12755,1906,34.6,12561,14.2,35.5,1784,194,122,6.84,-0.31,-0.54,-0.448
"2747","48447",1541,406,48.2,1626,25.8,49.2,420,-85,-14,-3.33,-0.33,-1.37,-0.954
"2748","48449",32664,4372,34,32045,11.7,32.8,3749,619,623,16.62,-0.24,0.26,0.06
"2749","48451",116906,17079,34,110434,13.8,34.2,15240,6472,1839,12.07,-0.06,-0.11,-0.09
"2750","48453",1176584,104344,33.6,1034842,7.4,32,76578,141742,27766,36.26,3.7,1.87,2.602
"2751","48455",14481,3786,48.5,14466,23,46.5,3327,15,459,13.8,-0.26,0.03,-0.086
"2752","48457",21456,4526,43,21638,19.4,42.2,4198,-182,328,7.81,-0.28,-0.46,-0.388
"2753","48459",40506,6966,40.7,39386,15.6,40.4,6144,1120,822,13.38,-0.21,0,-0.084
"2754","48461",3575,482,33.7,3300,14.8,37.1,488,275,-6,-1.23,-0.33,-1.2,-0.852
"2755","48463",27015,4431,33.8,26434,15,35.2,3965,581,466,11.75,-0.26,-0.14,-0.188
"2756","48465",48976,6810,31.7,48578,12.5,32.6,6072,398,738,12.15,-0.22,-0.11,-0.154
"2757","48467",53607,10677,43.3,52507,18.3,42.3,9609,1100,1068,11.11,-0.17,-0.19,-0.182
"2758","48469",91518,13697,35.7,87188,13.5,36.2,11770,4330,1927,16.37,-0.05,0.24,0.124
"2759","48471",70818,8473,35.2,67447,10.3,35,6947,3371,1526,21.97,-0.1,0.7,0.38
"2760","48473",48443,5519,28.8,42894,10.4,32.3,4461,5549,1058,23.72,-0.17,0.84,0.436
"2761","48475",11498,1614,33.6,10705,14.4,36.5,1542,793,72,4.67,-0.32,-0.72,-0.56
"2762","48477",34667,7045,42,33628,18.6,41.1,6255,1039,790,12.63,-0.21,-0.07,-0.126
"2763","48479",269624,23659,28.4,250320,7.9,27.8,19775,19304,3884,19.64,0.24,0.51,0.402
"2764","48481",41430,6603,37.3,41153,14.7,37.3,6049,277,554,9.16,-0.25,-0.35,-0.31
"2765","48483",5599,1018,39.4,5414,18.2,40.5,985,185,33,3.35,-0.32,-0.83,-0.626
"2766","48485",131778,18374,34.2,131019,13,34.1,17032,759,1342,7.88,-0.13,-0.46,-0.328
"2767","48487",12972,2157,37.2,13451,16.3,37.8,2193,-479,-36,-1.64,-0.33,-1.24,-0.876
"2768","48489",21839,2858,33.4,21983,11.9,31.9,2616,-144,242,9.25,-0.29,-0.34,-0.32
"2769","48491",508313,56929,35.8,426296,9.1,34.4,38793,82017,18136,46.75,2.3,2.73,2.558
"2770","48493",47205,6863,40.4,42999,12.9,39.8,5547,4206,1316,23.72,-0.14,0.84,0.448
"2771","48495",7777,873,32.6,7137,12,34.4,856,640,17,1.99,-0.32,-0.94,-0.692
"2772","48497",63247,9228,38.5,59351,12.5,38.5,7419,3896,1809,24.38,-0.06,0.9,0.516
"2773","48499",43315,11631,48.1,41927,23.8,47.5,9979,1388,1652,16.55,-0.09,0.25,0.114
"2774","48501",8481,944,31.7,7918,11.5,31.8,911,563,33,3.62,-0.32,-0.8,-0.608
"2775","48503",18166,3583,41.5,18368,18.4,42.4,3380,-202,203,6.01,-0.3,-0.61,-0.486
"2776","48505",14415,1832,29.4,14014,10.3,27.9,1443,401,389,26.96,-0.27,1.11,0.558
"2777","48507",12152,1614,30.8,11753,12.4,31.1,1457,399,157,10.78,-0.3,-0.22,-0.252
"2778","49001",6414,886,33.3,6527,12.5,31.5,816,-113,70,8.58,-0.32,-0.4,-0.368
"2779","49003",52182,6391,32.3,49660,11.3,30.9,5612,2522,779,13.88,-0.21,0.04,-0.06
"2780","49005",120288,10449,25,112095,7.8,25.5,8743,8193,1706,19.51,-0.08,0.5,0.268
"2781","49007",20512,3214,36.4,21153,13.9,34.6,2940,-641,274,9.32,-0.29,-0.34,-0.32
"2782","49009",702,119,47.3,897,21.6,48.2,194,-195,-75,-38.66,-0.34,-4.27,-2.698
"2783","49011",334977,31376,30.6,306664,8.3,29.4,25453,28313,5923,23.27,0.53,0.81,0.698
"2784","49013",20259,2159,30.3,18537,10.5,29.8,1946,1722,213,10.95,-0.29,-0.2,-0.236
"2785","49015",10410,1582,35,10902,12.8,33,1395,-492,187,13.41,-0.3,0,-0.12
"2786","49017",5020,997,41.2,5107,16.8,40.8,858,-87,139,16.2,-0.31,0.23,0.014
"2787","49019",9544,1572,39.8,9183,13.4,40,1231,361,341,27.7,-0.28,1.17,0.59
"2788","49021",48504,5748,29.1,45984,10,26.6,4598,2520,1150,25.01,-0.16,0.95,0.506
"2789","49023",10694,1232,30.7,10233,10.1,29.6,1034,461,198,19.15,-0.3,0.47,0.162
"2790","49025",7246,1587,42.2,7093,19,45.5,1348,153,239,17.73,-0.29,0.35,0.094
"2791","49027",12651,2016,35.5,12436,14.2,34,1766,215,250,14.16,-0.29,0.06,-0.08
"2792","49029",11014,1224,32.4,9485,10.7,31.9,1015,1529,209,20.59,-0.3,0.59,0.234
"2793","49031",1860,476,40.6,1699,21.5,42.2,365,161,111,30.41,-0.31,1.39,0.71
"2794","49033",2307,391,34.3,2264,14.8,33,335,43,56,16.72,-0.32,0.27,0.034
"2795","49035",1106700,110372,32.4,1032226,8.7,30.8,89804,74474,20568,22.9,2.65,0.77,1.522
"2796","49037",15193,1938,31.6,14707,10.9,30.2,1603,486,335,20.9,-0.28,0.61,0.254
"2797","49039",28892,3750,31.7,27645,11.6,28.9,3207,1247,543,16.93,-0.25,0.29,0.074
"2798","49041",20961,3262,34.9,20759,14.4,32.9,2989,202,273,9.13,-0.29,-0.35,-0.326
"2799","49043",39731,4202,38.8,36598,7.8,36.7,2855,3133,1347,47.18,-0.13,2.76,1.604
"2800","49045",63357,5434,31.1,58158,7.2,29.5,4187,5199,1247,29.78,-0.15,1.34,0.744
"2801","49047",36343,3378,30.1,32809,9.2,29.4,3018,3534,360,11.93,-0.27,-0.12,-0.18
"2802","49049",576496,41777,24.5,516571,6.6,24.5,34094,59925,7683,22.53,0.79,0.74,0.76
"2803","49051",29306,2883,33.3,23661,8.6,31.9,2035,5645,848,41.67,-0.2,2.31,1.306
"2804","49053",155577,30973,35.9,139484,17.3,32.5,24131,16093,6842,28.35,0.67,1.22,1
"2805","49055",2700,514,40.4,2756,15.7,36.9,433,-56,81,18.71,-0.31,0.43,0.134
"2806","49057",244101,27193,32.3,230940,10.3,30.9,23787,13161,3406,14.32,0.17,0.07,0.11
"2807","50001",36825,6525,43.4,36814,14.1,41.8,5191,11,1334,25.7,-0.13,1,0.548
"2808","50003",36054,7723,46.6,36990,18.9,45.1,6991,-936,732,10.47,-0.22,-0.24,-0.232
"2809","50005",30576,5616,43.7,31170,15.6,42.3,4863,-594,753,15.48,-0.22,0.17,0.014
"2810","50007",160985,21842,36.6,156696,11.5,36.4,18020,4289,3822,21.21,0.23,0.64,0.476
"2811","50009",6203,1485,50,6316,19.5,46.7,1232,-113,253,20.54,-0.29,0.58,0.232
"2812","50011",48816,7102,39.9,47853,12.3,39.6,5886,963,1216,20.66,-0.15,0.59,0.294
"2813","50013",6950,1275,48.1,7032,14.3,45.8,1006,-82,269,26.74,-0.29,1.09,0.538
"2814","50015",25191,3935,40.5,24471,13.2,40.1,3230,720,705,21.83,-0.22,0.69,0.326
"2815","50017",28901,5440,45.7,28980,15,43.5,4347,-79,1093,25.14,-0.17,0.96,0.508
"2816","50019",26951,5631,45.4,27198,17.9,43.9,4868,-247,763,15.67,-0.22,0.18,0.02
"2817","50021",59676,11986,46.4,61599,16.8,44.3,10349,-1923,1637,15.82,-0.09,0.19,0.078
"2818","50023",58691,10458,43.5,59462,14.6,42.5,8681,-771,1777,20.47,-0.07,0.58,0.32
"2819","50025",43332,8748,46.8,44310,16.3,44.9,7223,-978,1525,21.11,-0.1,0.63,0.338
"2820","50027",55485,11785,47.4,56607,17.9,45.5,10133,-1122,1652,16.3,-0.09,0.23,0.102
"2821","51001",32840,7033,46,33454,19,44.5,6356,-614,677,10.65,-0.23,-0.23,-0.23
"2822","51003",105105,17522,38.6,99484,14.5,38.2,14425,5621,3097,21.47,0.12,0.66,0.444
"2823","51005",15489,3576,46.9,16297,20.8,46.1,3390,-808,186,5.49,-0.3,-0.65,-0.51
"2824","51007",12802,2364,46.5,12674,16.4,41.6,2079,128,285,13.71,-0.28,0.02,-0.1
"2825","51009",31819,6208,43.9,32301,16.9,42.4,5459,-482,749,13.72,-0.22,0.02,-0.076
"2826","51011",15462,3017,43.5,14952,17.6,42.3,2632,510,385,14.63,-0.27,0.1,-0.048
"2827","51013",229534,22553,34.4,209077,8.7,33.7,18190,20457,4363,23.99,0.31,0.86,0.64
"2828","51015",74390,14309,44.6,73662,16.2,43.3,11933,728,2376,19.91,0.02,0.53,0.326
"2829","51017",4458,794,47.3,4713,20,45.4,943,-255,-149,-15.8,-0.35,-2.4,-1.58
"2830","51019",77319,15336,45.9,68750,16.4,44,11275,8569,4061,36.02,0.26,1.85,1.214
"2831","51021",6524,1340,45.3,6827,17.7,44.2,1208,-303,132,10.93,-0.31,-0.21,-0.25
"2832","51023",33149,6813,47.2,33074,16.9,45,5590,75,1223,21.88,-0.15,0.69,0.354
"2833","51025",16435,3235,43.4,17372,16.8,41,2918,-937,317,10.86,-0.28,-0.21,-0.238
"2834","51027",22611,4518,46.3,24071,17.1,43.9,4116,-1460,402,9.77,-0.27,-0.3,-0.288
"2835","51029",17048,3000,42.7,17071,14.4,41.4,2458,-23,542,22.05,-0.25,0.71,0.326
"2836","51031",55158,10287,42.8,54797,16.1,41.4,8822,361,1465,16.61,-0.11,0.26,0.112
"2837","51033",29889,4599,40.2,28510,13.1,38.6,3735,1379,864,23.13,-0.2,0.79,0.394
"2838","51035",29767,6651,47,29989,19.5,45,5848,-222,803,13.73,-0.21,0.02,-0.072
"2839","51036",7022,1546,49.8,7226,17.4,47.1,1257,-204,289,22.99,-0.28,0.78,0.356
"2840","51037",12176,2566,45.2,12546,18.7,43.5,2346,-370,220,9.38,-0.29,-0.33,-0.314
"2841","51041",335594,44886,38.8,316895,10.6,37.5,33591,18699,11295,33.63,1.31,1.65,1.514
"2842","51043",14331,2823,46,14143,16.4,44.7,2319,188,504,21.73,-0.25,0.68,0.308
"2843","51045",5131,1092,47.5,5186,16.2,45,840,-55,252,30,-0.29,1.36,0.7
"2844","51047",49795,7271,38.8,46894,12,37.9,5627,2901,1644,29.22,-0.09,1.29,0.738
"2845","51049",9797,2002,44.5,9951,16.8,41.8,1672,-154,330,19.74,-0.28,0.52,0.2
"2846","51051",15181,3046,43.9,15877,17,43.5,2699,-696,347,12.86,-0.28,-0.05,-0.142
"2847","51053",28033,4550,42.9,27926,14.1,40.8,3938,107,612,15.54,-0.24,0.17,0.00600000000000001
"2848","51057",11083,2285,44.8,11130,17.8,43.8,1981,-47,304,15.35,-0.28,0.16,-0.016
"2849","51059",1142004,138977,37.9,1083770,10,37.5,108377,58234,30600,28.23,4.11,1.21,2.37
"2850","51061",68406,10438,41.6,65495,12.9,41,8449,2911,1989,23.54,-0.04,0.83,0.482
"2851","51063",15594,3259,46,15268,17.8,44.2,2718,326,541,19.9,-0.25,0.53,0.218
"2852","51065",26109,4710,42.6,25749,15.7,41.1,4043,360,667,16.5,-0.23,0.25,0.058
"2853","51067",56277,12025,46,56012,18,44.3,10082,265,1943,19.27,-0.04,0.48,0.272
"2854","51069",83784,13127,40.5,78397,12.7,39.2,9956,5387,3171,31.85,0.13,1.51,0.958
"2855","51071",16867,3478,44.4,17149,18.1,43,3104,-282,374,12.05,-0.27,-0.11,-0.174
"2856","51073",37035,6558,44.6,36821,15,41.9,5523,214,1035,18.74,-0.18,0.43,0.186
"2857","51075",22148,4428,48.4,21496,15.5,45.3,3332,652,1096,32.89,-0.17,1.59,0.886
"2858","51077",15708,3585,47.4,15535,21.2,47,3293,173,292,8.87,-0.28,-0.37,-0.334
"2859","51079",19213,3006,39.6,18453,13.5,39.5,2491,760,515,20.67,-0.25,0.59,0.254
"2860","51081",11606,1715,41.1,12127,12.9,42.1,1564,-521,151,9.65,-0.3,-0.31,-0.306
"2861","51083",35030,7800,45.9,36140,19.5,44.6,7047,-1110,753,10.69,-0.22,-0.23,-0.226
"2862","51085",103218,16526,42.6,99964,13.2,41.2,13195,3254,3331,25.24,0.16,0.97,0.646
"2863","51087",324073,45872,38.3,307576,12.4,37.5,38139,16497,7733,20.28,0.79,0.56,0.652
"2864","51089",51956,11691,46.8,53971,19.6,44.5,10578,-2015,1113,10.52,-0.16,-0.24,-0.208
"2865","51091",2213,859,60.5,2317,28.9,56.5,670,-104,189,28.21,-0.3,1.21,0.606
"2866","51093",36090,6276,44.4,35240,14.7,43.7,5180,850,1096,21.16,-0.17,0.63,0.31
"2867","51095",73028,17264,45.9,66939,20.7,44.9,13856,6089,3408,24.6,0.17,0.91,0.614
"2868","51097",7052,1537,45.1,6968,17.9,44.7,1247,84,290,23.26,-0.28,0.8,0.368
"2869","51099",25564,3096,37.1,23739,10.2,36.5,2421,1825,675,27.88,-0.23,1.18,0.616
"2870","51101",16329,2421,41.3,15861,12.6,39.3,1998,468,423,21.17,-0.26,0.63,0.274
"2871","51103",10848,3755,56.3,11371,31.4,54.2,3570,-523,185,5.18,-0.3,-0.68,-0.528
"2872","51105",24428,4650,43.8,25528,16.2,41.4,4136,-1100,514,12.43,-0.25,-0.08,-0.148
"2873","51107",374558,31172,35.8,314980,6.7,34.8,21104,59578,10068,47.71,1.13,2.81,2.138
"2874","51109",34813,6332,44.5,33083,14.7,43.1,4863,1730,1469,30.21,-0.11,1.37,0.778
"2875","51111",12369,2523,45.4,12838,17.5,43.8,2247,-469,276,12.28,-0.29,-0.1,-0.176
"2876","51113",13108,2650,45.2,13270,18.7,44.7,2481,-162,169,6.81,-0.3,-0.54,-0.444
"2877","51115",8830,2611,52.6,8965,26.1,50.3,2340,-135,271,11.58,-0.29,-0.15,-0.206
"2878","51117",30959,7483,47.9,32548,21,45.9,6835,-1589,648,9.48,-0.23,-0.32,-0.284
"2879","51119",10710,3206,53.5,10855,26.1,51.2,2833,-145,373,13.17,-0.27,-0.02,-0.12
"2880","51121",97692,11255,28.2,94179,9.8,26.5,9230,3513,2025,21.94,-0.03,0.7,0.408
"2881","51125",14863,3621,49.7,15000,18.7,47.7,2805,-137,816,29.09,-0.21,1.28,0.684
"2882","51127",20523,3260,44,18460,12.3,42,2271,2063,989,43.55,-0.18,2.47,1.41
"2883","51131",11998,3019,48.4,12408,22.5,47.3,2792,-410,227,8.13,-0.29,-0.44,-0.38
"2884","51133",12254,4308,56.5,12389,30.3,53.5,3754,-135,554,14.76,-0.25,0.11,-0.034
"2885","51135",15537,2839,41.3,15875,17.1,43,2715,-338,124,4.57,-0.31,-0.73,-0.562
"2886","51137",35265,6954,41.9,33625,18,42.7,6052,1640,902,14.9,-0.2,0.12,-0.00800000000000002
"2887","51139",23694,4823,45,24038,18,43,4327,-344,496,11.46,-0.25,-0.16,-0.196
"2888","51141",17958,4416,49.2,18513,21.7,46.1,4017,-555,399,9.93,-0.27,-0.29,-0.282
"2889","51143",61970,12650,46.4,63318,17.5,44.3,11081,-1348,1569,14.16,-0.1,0.06,-0.00400000000000001
"2890","51145",28364,4688,44.6,28003,12.4,42.1,3472,361,1216,35.02,-0.15,1.77,1.002
"2891","51147",22903,3542,30.8,23017,14.2,33.4,3268,-114,274,8.38,-0.29,-0.41,-0.362
"2892","51149",37704,4766,37.1,36013,10.5,37.6,3781,1691,985,26.05,-0.18,1.03,0.546
"2893","51153",450763,39436,34.7,404011,6.9,33.5,27877,46752,11559,41.46,1.35,2.3,1.92
"2894","51155",34330,7350,46.2,34869,18,44.2,6276,-539,1074,17.11,-0.17,0.3,0.112
"2895","51157",7359,1793,49.5,7440,19.9,48,1481,-81,312,21.07,-0.28,0.63,0.266
"2896","51159",8873,1834,44,9234,18.3,43.2,1690,-361,144,8.52,-0.3,-0.4,-0.36
"2897","51161",93419,18531,43.7,92432,17.4,42.9,16083,987,2448,15.22,0.03,0.15,0.102
"2898","51163",22440,5451,48.6,22357,20.8,46.8,4650,83,801,17.23,-0.21,0.31,0.102
"2899","51165",78653,14200,41.8,76353,16,40.3,12216,2300,1984,16.24,-0.04,0.23,0.122
"2900","51167",27725,5340,44.8,28773,16.8,42.9,4834,-1048,506,10.47,-0.25,-0.24,-0.244
"2901","51169",22290,4947,46.3,23061,19.7,44.7,4543,-771,404,8.89,-0.27,-0.37,-0.33
"2902","51171",42854,8796,44.2,42076,18.5,42.7,7784,778,1012,13,-0.18,-0.04,-0.096
"2903","51173",31298,6422,44.6,32103,18.4,43.3,5907,-805,515,8.72,-0.25,-0.39,-0.334
"2904","51175",18089,3279,45.8,18576,15.8,43.9,2935,-487,344,11.72,-0.28,-0.14,-0.196
"2905","51177",130159,16487,37.7,122854,10,36.4,12285,7305,4202,34.2,0.28,1.7,1.132
"2906","51179",141159,13257,35.2,129446,7.5,34.5,9708,11713,3549,36.56,0.19,1.89,1.21
"2907","51181",6670,1322,49.3,6988,16.4,45.3,1146,-318,176,15.36,-0.3,0.16,-0.024
"2908","51183",11595,1902,40.4,12095,15,40.5,1814,-500,88,4.85,-0.31,-0.7,-0.544
"2909","51185",42689,8443,44.3,44846,17.4,43.4,7803,-2157,640,8.2,-0.23,-0.43,-0.35
"2910","51187",38991,5770,40.6,37567,13,39.8,4884,1424,886,18.14,-0.2,0.38,0.148
"2911","51191",54457,11408,45.5,54691,18,43.2,9844,-234,1564,15.89,-0.1,0.2,0.08
"2912","51193",17596,4158,47.6,17468,21.2,46.5,3703,128,455,12.29,-0.26,-0.09,-0.158
"2913","51195",39539,6456,40.3,41361,14.3,39.5,5915,-1822,541,9.15,-0.25,-0.35,-0.31
"2914","51197",29048,5817,44.4,29203,17.5,42.9,5111,-155,706,13.81,-0.22,0.03,-0.07
"2915","51199",67196,9904,39.6,65503,12.2,39.6,7991,1693,1913,23.94,-0.05,0.86,0.496
"2916","51510",154710,16239,36.4,140337,9.3,35.7,13051,14373,3188,24.43,0.14,0.9,0.596
"2917","51520",17077,3374,42.3,17747,19.2,40.8,3407,-670,-33,-0.97,-0.33,-1.18,-0.84
"2918","51530",6495,1149,36.4,6679,17.2,38,1149,-184,0,0,-0.33,-1.1,-0.792
"2919","51540",46487,4826,30.9,43223,9.3,28.1,4020,3264,806,20.05,-0.21,0.54,0.24
"2920","51550",235410,28596,36.6,223233,10.5,36.7,23439,12177,5157,22,0.42,0.7,0.588
"2921","51570",17582,3562,40.1,17426,19.4,41.6,3381,156,181,5.35,-0.3,-0.66,-0.516
"2922","51580",5675,1232,44.2,5903,18.7,43.8,1104,-228,128,11.59,-0.31,-0.15,-0.214
"2923","51590",41911,8259,40.6,43185,19,42.7,8205,-1274,54,0.66,-0.32,-1.05,-0.758
"2924","51595",5495,921,35.9,5825,18.1,39.2,1054,-330,-133,-12.62,-0.34,-2.14,-1.42
"2925","51600",23580,3375,39,22712,13.8,38.5,3134,868,241,7.69,-0.29,-0.47,-0.398
"2926","51610",13843,1725,39.7,12300,10.4,36.9,1279,1543,446,34.87,-0.26,1.76,0.952
"2927","51620",8334,1539,38.7,8531,17.1,40.1,1459,-197,80,5.48,-0.31,-0.65,-0.514
"2928","51630",28135,2960,29.9,24932,10,28.8,2493,3203,467,18.73,-0.26,0.43,0.154
"2929","51640",6788,1561,46.6,6942,24.9,44.7,1729,-154,-168,-9.72,-0.35,-1.9,-1.28
"2930","51650",136255,19193,35.8,137471,12.2,35.5,16771,-1216,2422,14.44,0.03,0.08,0.06
"2931","51660",53064,4608,24.8,49043,8,22.7,3923,4021,685,17.46,-0.23,0.33,0.106
"2932","51670",22353,3463,36.5,22501,14.9,35.9,3353,-148,110,3.28,-0.31,-0.83,-0.622
"2933","51678",7113,1067,21.6,6990,12.6,21.7,881,123,186,21.11,-0.3,0.63,0.258
"2934","51680",79237,11016,28.3,75657,13.8,30.3,10441,3580,575,5.51,-0.24,-0.65,-0.486
"2935","51683",41379,3646,33.5,37943,7.4,32.3,2808,3436,838,29.84,-0.2,1.34,0.724
"2936","51685",16117,1200,34.1,14409,5.8,31,836,1708,364,43.54,-0.27,2.47,1.374
"2937","51690",13256,2563,41.5,13854,19.5,44.1,2702,-598,-139,-5.14,-0.35,-1.52,-1.052
"2938","51700",180775,21787,33.2,180831,10.7,32.3,19349,-56,2438,12.6,0.03,-0.07,-0.03
"2939","51710",245752,25271,30.4,243056,9.5,29.6,23090,2696,2181,9.45,-0.01,-0.33,-0.202
"2940","51720",4043,682,37.2,3971,12.6,39.8,500,72,182,36.4,-0.3,1.88,1.008
"2941","51730",32037,5230,38.3,32226,14.9,39.8,4802,-189,428,8.91,-0.26,-0.37,-0.326
"2942","51735",12022,2226,42.2,12110,15.7,43.3,1901,-88,325,17.1,-0.28,0.3,0.068
"2943","51740",95536,13344,35.2,95786,13.3,35.3,12740,-250,604,4.74,-0.24,-0.71,-0.522
"2944","51750",17380,1479,22.7,16511,8.5,21.9,1403,869,76,5.42,-0.31,-0.66,-0.52
"2945","51760",220892,26622,33.5,205348,11.2,32.2,22999,15544,3623,15.75,0.2,0.19,0.194
"2946","51770",99572,15372,38.4,96742,14.3,38.4,13834,2830,1538,11.12,-0.1,-0.19,-0.154
"2947","51775",25521,4711,41.1,24792,16.6,39.8,4115,729,596,14.48,-0.24,0.09,-0.042
"2948","51790",24273,4919,42,23906,19.6,42.6,4686,367,233,4.97,-0.29,-0.69,-0.53
"2949","51800",88057,11759,38.1,84216,11.7,38.2,9853,3841,1906,19.34,-0.05,0.48,0.268
"2950","51810",450057,57339,35.6,439528,10.7,34.8,47029,10529,10310,21.92,1.17,0.69,0.882
"2951","51820",21620,4021,40,21030,16.8,38.2,3533,590,488,13.81,-0.25,0.03,-0.082
"2952","51830",14817,2159,24.5,14207,13.4,24.1,1904,610,255,13.39,-0.29,0,-0.116
"2953","51840",27516,4176,37.6,26330,13.7,35.6,3607,1186,569,15.77,-0.24,0.19,0.018
"2954","53001",19261,2061,28.4,18575,10.1,29.2,1876,686,185,9.86,-0.3,-0.29,-0.294
"2955","53003",22259,4809,44.7,21658,19.4,43.3,4202,601,607,14.45,-0.24,0.08,-0.048
"2956","53005",190529,26138,35.6,175424,11.8,35.7,20700,15105,5438,26.27,0.46,1.05,0.814
"2957","53007",75138,13239,39.9,72431,15.4,39.8,11154,2707,2085,18.69,-0.02,0.43,0.25
"2958","53009",73439,20155,50.5,71411,24.2,49,17281,2028,2874,16.63,0.09,0.26,0.192
"2959","53011",457474,64408,38,426984,11.6,36.8,49530,30490,14878,30.04,1.83,1.36,1.548
"2960","53013",3999,1076,50,4001,23.7,48.9,948,-2,128,13.5,-0.31,0,-0.124
"2961","53015",103590,18821,41.4,102138,15.7,40.1,16036,1452,2785,17.37,0.08,0.32,0.224
"2962","53017",40585,6563,37.3,38369,13.9,36.8,5333,2216,1230,23.06,-0.15,0.79,0.414
"2963","53019",7568,1734,49,7584,18.7,47,1418,-16,316,22.28,-0.28,0.72,0.32
"2964","53021",89124,7508,29.9,78680,7.3,28.4,5744,10444,1764,30.71,-0.07,1.41,0.818
"2965","53023",2226,515,46.7,2246,25.3,52.6,568,-20,-53,-9.33,-0.33,-1.87,-1.254
"2966","53025",93420,12039,32.6,88885,12,32.1,10666,4535,1373,12.87,-0.13,-0.05,-0.082
"2967","53027",71454,13976,43.5,72272,16.4,42,11853,-818,2123,17.91,-0.02,0.37,0.214
"2968","53029",80323,18260,44.1,78707,18.6,43.6,14640,1616,3620,24.73,0.2,0.92,0.632
"2969","53031",30524,10062,57.1,29802,26.5,53.8,7898,722,2164,27.4,-0.01,1.14,0.68
"2970","53033",2118119,263820,37.2,1940777,11,37.1,213485,177342,50335,23.58,6.96,0.83,3.282
"2971","53035",258903,42340,39.1,251400,13.4,39.3,33688,7503,8652,25.68,0.93,1,0.972
"2972","53037",43726,6563,33.3,40954,12.8,32.4,5242,2772,1321,25.2,-0.13,0.96,0.524
"2973","53039",21172,4594,45.9,20421,18.1,45.3,3696,751,898,24.3,-0.2,0.89,0.454
"2974","53041",76012,15140,42.8,75399,17.4,42,13119,613,2021,15.41,-0.03,0.16,0.084
"2975","53043",10344,2559,48.6,10536,21.1,47.8,2223,-192,336,15.11,-0.28,0.14,-0.028
"2976","53045",61569,13338,45.9,60545,18.5,44.5,11201,1024,2137,19.08,-0.02,0.46,0.268
"2977","53047",41377,8410,43.1,40959,17.1,42.2,7004,418,1406,20.07,-0.12,0.54,0.276
"2978","53049",20940,6004,52.7,20945,25,50.7,5236,-5,768,14.67,-0.21,0.1,-0.024
"2979","53051",13066,3180,50.2,12976,19.5,47.6,2530,90,650,25.69,-0.23,1,0.508
"2980","53053",845193,108980,36,798528,11.1,35.7,88637,46665,20343,22.95,2.62,0.78,1.516
"2981","53055",16221,4961,55.7,15740,23.5,52.9,3699,481,1262,34.12,-0.14,1.69,0.958
"2982","53057",121725,23285,41.4,117087,16.3,40.2,19085,4638,4200,22.01,0.28,0.7,0.532
"2983","53059",11498,2122,46,11053,14.3,44.5,1581,445,541,34.22,-0.25,1.7,0.92
"2984","53061",771904,95299,37.8,714443,10.5,37.2,75017,57461,20282,27.04,2.61,1.11,1.71
"2985","53063",490764,73585,37.4,470375,13.1,36.8,61619,20389,11966,19.42,1.41,0.49,0.858
"2986","53065",43858,9288,46.4,43498,17.5,45.1,7612,360,1676,22.02,-0.08,0.7,0.388
"2987","53067",269885,42272,38.9,252410,13.2,38.3,33318,17475,8954,26.87,0.97,1.1,1.048
"2988","53069",4105,1306,53.3,4003,24.6,48.8,985,102,321,32.59,-0.28,1.57,0.83
"2989","53071",59862,9955,37.3,58643,15.1,37,8855,1219,1100,12.42,-0.17,-0.08,-0.116
"2990","53073",212738,33931,36.9,201404,13.4,36.5,26988,11334,6943,25.73,0.68,1.01,0.878
"2991","53075",47794,4700,24.5,44997,9.5,24.1,4275,2797,425,9.94,-0.26,-0.29,-0.278
"2992","53077",248279,32044,32.7,242454,11.7,32.4,28367,5825,3677,12.96,0.21,-0.04,0.06
"2993","54001",16790,3118,40.9,16472,16.8,41.4,2767,318,351,12.69,-0.27,-0.06,-0.144
"2994","54003",111610,15268,38.8,104410,11.5,37.6,12007,7200,3261,27.16,0.15,1.12,0.732
"2995","54005",23236,4082,42.5,24617,14.4,41.2,3545,-1381,537,15.15,-0.25,0.14,-0.016
"2996","54007",14345,2943,44.9,14531,17.8,43.4,2587,-186,356,13.76,-0.27,0.03,-0.09
"2997","54009",23067,5040,46.2,24021,19.4,44.9,4660,-954,380,8.15,-0.27,-0.43,-0.366
"2998","54011",96100,16746,38.3,96240,16,39,15398,-140,1348,8.75,-0.13,-0.38,-0.28
"2999","54013",7450,1661,47.9,7613,18.4,45.4,1401,-163,260,18.56,-0.29,0.42,0.136
"3000","54015",8901,1677,43.6,9432,15.9,41.9,1500,-531,177,11.8,-0.3,-0.13,-0.198
"3001","54017",8570,1663,44.5,8147,16,41.9,1304,423,359,27.53,-0.27,1.15,0.582
"3002","54019",44602,8493,43.3,46000,17.1,42.3,7866,-1398,627,7.97,-0.23,-0.45,-0.362
"3003","54021",8305,1288,38,8623,14.5,38.8,1250,-318,38,3.04,-0.32,-0.85,-0.638
"3004","54023",11673,2668,46.3,11929,18.5,44,2207,-256,461,20.89,-0.26,0.61,0.262
"3005","54025",35523,7772,45.4,35572,19.4,44.8,6901,-49,871,12.62,-0.2,-0.07,-0.122
"3006","54027",23412,4736,45.4,23791,16.3,42.7,3878,-379,858,22.12,-0.2,0.71,0.346
"3007","54029",29921,6340,46.1,30594,19,45.1,5813,-673,527,9.07,-0.25,-0.36,-0.316
"3008","54031",13812,2763,44.9,13912,16.9,42.1,2351,-100,412,17.52,-0.27,0.33,0.09
"3009","54033",68438,12412,42,68959,16.6,41.7,11447,-521,965,8.43,-0.19,-0.41,-0.322
"3010","54035",29123,5537,43,29206,17.8,41.5,5199,-83,338,6.5,-0.28,-0.57,-0.454
"3011","54037",55673,8146,40.2,53545,11.8,39.2,6318,2128,1828,28.93,-0.06,1.27,0.738
"3012","54039",187827,35257,43.1,192572,16.9,42.3,32545,-4745,2712,8.33,0.07,-0.42,-0.224
"3013","54041",16371,3195,42.8,16389,17.9,44,2934,-18,261,8.9,-0.29,-0.37,-0.338
"3014","54043",21241,3699,42.7,21714,15.2,41.3,3301,-473,398,12.06,-0.27,-0.11,-0.174
"3015","54045",34428,6055,43,36508,15.3,42.2,5586,-2080,469,8.4,-0.26,-0.41,-0.35
"3016","54047",19707,3762,44,21966,16.6,44,3646,-2259,116,3.18,-0.31,-0.84,-0.628
"3017","54049",56575,10441,41.3,56460,17,41.3,9598,115,843,8.78,-0.2,-0.38,-0.308
"3018","54051",32006,6432,44.9,32993,17.7,44,5840,-987,592,10.14,-0.24,-0.27,-0.258
"3019","54053",27000,5249,44,27242,17.1,42.2,4658,-242,591,12.69,-0.24,-0.06,-0.132
"3020","54055",60963,12303,42.7,62251,18,42.1,11205,-1288,1098,9.8,-0.17,-0.3,-0.248
"3021","54057",27421,5484,43.5,28049,17.5,42.1,4909,-628,575,11.71,-0.24,-0.14,-0.18
"3022","54059",25150,4180,42.1,26660,13.8,41.7,3679,-1510,501,13.62,-0.25,0.01,-0.094
"3023","54061",103715,11750,30.9,96417,10.2,29.3,9835,7298,1915,19.47,-0.05,0.49,0.274
"3024","54063",13517,3311,47.7,13528,19.5,44.9,2638,-11,673,25.51,-0.23,0.99,0.502
"3025","54065",17510,3727,47,17507,18.4,44.9,3221,3,506,15.71,-0.25,0.19,0.014
"3026","54067",25496,5242,44.9,26201,17.2,43.9,4507,-705,735,16.31,-0.22,0.24,0.056
"3027","54069",42906,8665,43.5,44307,18.5,43.2,8197,-1401,468,5.71,-0.26,-0.63,-0.482
"3028","54071",7138,1793,49.9,7666,22.3,47.6,1710,-528,83,4.85,-0.31,-0.7,-0.544
"3029","54073",7527,1349,43.4,7630,16.4,42.1,1251,-103,98,7.83,-0.31,-0.46,-0.4
"3030","54075",8574,1992,48.6,8750,19.7,47.5,1724,-176,268,15.55,-0.29,0.17,-0.014
"3031","54077",33760,6149,42.6,33471,15.8,41.7,5288,289,861,16.28,-0.2,0.23,0.058
"3032","54079",56644,9476,41.6,55660,14.5,41.2,8071,984,1405,17.41,-0.12,0.33,0.15
"3033","54081",77097,14460,42,78852,16.2,40.7,12774,-1755,1686,13.2,-0.08,-0.02,-0.044
"3034","54083",29152,5898,43.1,29361,18,43.6,5285,-209,613,11.6,-0.24,-0.15,-0.186
"3035","54085",10005,2110,45.8,10391,17.9,44.4,1860,-386,250,13.44,-0.29,0,-0.116
"3036","54087",14348,2864,44.8,14884,17.3,43.3,2575,-536,289,11.22,-0.28,-0.18,-0.22
"3037","54089",13210,2970,47.3,13813,19.4,46.2,2680,-603,290,10.82,-0.28,-0.21,-0.238
"3038","54091",16977,3144,43.2,16889,16.6,42.4,2804,88,340,12.13,-0.28,-0.11,-0.178
"3039","54093",7035,1688,48.1,7109,20.8,46.2,1479,-74,209,14.13,-0.3,0.06,-0.084
"3040","54095",8949,1851,46.5,9188,18.4,45.1,1691,-239,160,9.46,-0.3,-0.33,-0.318
"3041","54097",24604,4637,41.8,24210,16.9,41.3,4091,394,546,13.35,-0.25,-0.01,-0.106
"3042","54099",41063,7896,43.3,42273,16.7,41.7,7060,-1210,836,11.84,-0.2,-0.13,-0.158
"3043","54101",8637,1838,46.2,9158,18.5,44.7,1694,-521,144,8.5,-0.3,-0.4,-0.36
"3044","54103",15793,3442,45.9,16526,19.8,44.9,3272,-733,170,5.2,-0.3,-0.68,-0.528
"3045","54105",5800,1060,43.4,5769,16,43.9,923,31,137,14.84,-0.31,0.11,-0.058
"3046","54107",86016,16461,43,86835,17,41.8,14762,-819,1699,11.51,-0.08,-0.16,-0.128
"3047","54109",22130,4143,43.8,23668,15.3,42.4,3621,-1538,522,14.42,-0.25,0.08,-0.052
"3048","55001",20111,5518,52.6,20898,23.7,48.9,4953,-787,565,11.41,-0.24,-0.17,-0.198
"3049","55003",15779,2784,41.7,16113,16.2,41,2610,-334,174,6.67,-0.3,-0.55,-0.45
"3050","55005",45358,9290,44.2,45882,18.3,42.7,8396,-524,894,10.65,-0.2,-0.23,-0.218
"3051","55007",15004,3766,51.6,15078,20.9,49.3,3151,-74,615,19.52,-0.24,0.5,0.204
"3052","55009",258004,34634,37,248526,11.6,36.2,28829,9478,5805,20.14,0.51,0.55,0.534
"3053","55011",13243,2740,45.7,13544,18.2,44,2465,-301,275,11.16,-0.29,-0.19,-0.23
"3054","55013",15239,4081,52.1,15528,23.6,49.3,3665,-289,416,11.35,-0.27,-0.17,-0.21
"3055","55015",49737,6754,39.8,48960,11.5,38.2,5630,777,1124,19.96,-0.16,0.53,0.254
"3056","55017",63445,10402,41.2,62362,14.6,40.2,9105,1083,1297,14.24,-0.14,0.07,-0.014
"3057","55019",34513,5545,37.5,34610,15.7,37.1,5434,-97,111,2.04,-0.31,-0.93,-0.682
"3058","55021",56790,9372,42.4,56596,14.7,41.3,8320,194,1052,12.64,-0.17,-0.07,-0.11
"3059","55023",16313,3426,45.7,16677,18.6,44.5,3102,-364,324,10.44,-0.28,-0.25,-0.262
"3060","55025",522837,64411,34.8,490379,10.4,34.4,50999,32458,13412,26.3,1.62,1.05,1.278
"3061","55027",87833,14317,42.4,88741,14.9,40.6,13222,-908,1095,8.28,-0.17,-0.42,-0.32
"3062","55029",27443,7448,52.3,27872,22.7,49.6,6327,-429,1121,17.72,-0.16,0.35,0.146
"3063","55031",43503,7344,41.3,43963,14.5,40,6375,-460,969,15.2,-0.19,0.14,0.00799999999999999
"3064","55033",44260,6485,34.2,43788,12.4,33.6,5430,472,1055,19.43,-0.17,0.49,0.226
"3065","55035",102388,14694,34.3,98952,12.6,33.2,12468,3436,2226,17.85,0,0.36,0.216
"3066","55037",4354,1050,51.9,4486,20.2,48.5,906,-132,144,15.89,-0.3,0.2,0
"3067","55039",102082,17280,41.2,101577,15.1,40.3,15338,505,1942,12.66,-0.04,-0.06,-0.052
"3068","55041",9035,1994,46.2,9361,20.5,44,1919,-326,75,3.91,-0.31,-0.78,-0.592
"3069","55043",51742,8423,35.6,51055,15.6,36.5,7965,687,458,5.75,-0.26,-0.63,-0.482
"3070","55045",36869,6259,42.8,36800,15.1,41.3,5557,69,702,12.63,-0.22,-0.07,-0.13
"3071","55047",18745,3926,45.5,19064,19.2,44.4,3660,-319,266,7.27,-0.29,-0.51,-0.422
"3072","55049",23576,3951,42.5,23712,14.2,41.4,3367,-136,584,17.34,-0.24,0.32,0.096
"3073","55051",5748,1643,53.8,5978,25.7,51,1536,-230,107,6.97,-0.31,-0.53,-0.442
"3074","55053",20531,3652,42.1,20436,16.1,41.6,3290,95,362,11,-0.27,-0.2,-0.228
"3075","55055",84586,13028,40.1,83751,13.3,38.1,11139,835,1889,16.96,-0.05,0.29,0.154
"3076","55057",26427,5189,45.2,26701,17.7,43.2,4726,-274,463,9.8,-0.26,-0.3,-0.284
"3077","55059",167886,21520,37.9,166373,11.3,36.5,18800,1513,2720,14.47,0.07,0.08,0.076
"3078","55061",20378,3829,43.9,20600,16.7,41.8,3440,-222,389,11.31,-0.27,-0.17,-0.21
"3079","55063",117582,17569,35.5,114718,13.4,35.3,15372,2864,2197,14.29,-0.01,0.07,0.038
"3080","55065",16755,2868,41.6,16836,15.6,41,2626,-81,242,9.22,-0.29,-0.35,-0.326
"3081","55067",19190,4269,47.6,19951,20.1,46.1,4010,-761,259,6.46,-0.29,-0.57,-0.458
"3082","55069",27994,5618,46.9,28710,18.6,44.8,5340,-716,278,5.21,-0.29,-0.67,-0.518
"3083","55071",79680,15019,44.5,81266,17.1,43.3,13896,-1586,1123,8.08,-0.16,-0.44,-0.328
"3084","55073",135293,21854,40.7,134041,14.3,39.2,19168,1252,2686,14.01,0.06,0.05,0.054
"3085","55075",40712,8968,47.7,41704,19.8,45.8,8257,-992,711,8.61,-0.22,-0.4,-0.328
"3086","55077",15164,3527,49.4,15366,20.9,47.2,3211,-202,316,9.84,-0.28,-0.3,-0.292
"3087","55078",4506,565,31.4,4274,13.3,32.6,568,232,-3,-0.53,-0.33,-1.14,-0.816
"3088","55079",956586,120158,34.6,946584,11.6,33.7,109804,10002,10354,9.43,1.17,-0.33,0.27
"3089","55081",45303,7156,39.5,44714,14.2,38.7,6349,589,807,12.71,-0.21,-0.06,-0.12
"3090","55083",37465,7145,46.3,37632,16.3,43.8,6134,-167,1011,16.48,-0.18,0.25,0.078
"3091","55085",35352,8582,50.6,36029,21.8,48.2,7854,-677,728,9.27,-0.22,-0.34,-0.292
"3092","55087",183288,24733,37.9,176777,11.9,37.3,21036,6511,3697,17.57,0.21,0.34,0.288
"3093","55089",87817,15862,43.9,86429,15.4,43,13310,1388,2552,19.17,0.04,0.47,0.298
"3094","55091",7282,1504,45.8,7458,18.2,43.8,1357,-176,147,10.83,-0.3,-0.21,-0.246
"3095","55093",41226,5447,36.6,40842,10.6,34.6,4329,384,1118,25.83,-0.16,1.02,0.548
"3096","55095",43328,8161,44.8,44094,16.3,42.8,7187,-766,974,13.55,-0.18,0.01,-0.066
"3097","55097",70371,10560,36.6,70027,12.9,35.8,9033,344,1527,16.9,-0.1,0.28,0.128
"3098","55099",13566,3240,51.3,14141,21.1,48.8,2984,-575,256,8.58,-0.29,-0.4,-0.356
"3099","55101",195101,29650,40.1,195024,13.2,39,25743,77,3907,15.18,0.24,0.14,0.18
"3100","55103",17626,3653,44.8,18020,18.4,42.9,3316,-394,337,10.16,-0.28,-0.27,-0.274
"3101","55105",161226,24728,39.3,160356,13.6,38.3,21808,870,2920,13.39,0.1,0,0.04
"3102","55107",14211,3235,48.6,14670,20.3,46.1,2978,-459,257,8.63,-0.29,-0.39,-0.35
"3103","55109",87142,10911,38.3,84363,10.1,36.8,8521,2779,2390,28.05,0.02,1.2,0.728
"3104","55111",63340,10845,41.3,61953,15.2,39.9,9417,1387,1428,15.16,-0.12,0.14,0.036
"3105","55113",16384,3906,49.7,16580,20.7,47.2,3432,-196,474,13.81,-0.26,0.03,-0.086
"3106","55115",41136,8230,44.9,41820,18.5,43.2,7737,-684,493,6.37,-0.25,-0.58,-0.448
"3107","55117",115094,19006,41.3,115377,14.6,40.2,16845,-283,2161,12.83,-0.01,-0.05,-0.034
"3108","55119",20344,3627,43.4,20631,16.5,41.8,3404,-287,223,6.55,-0.29,-0.56,-0.452
"3109","55121",29510,5016,40.5,28853,16,40.9,4616,657,400,8.67,-0.27,-0.39,-0.342
"3110","55123",30378,5566,42.3,29827,16.9,41.6,5041,551,525,10.41,-0.25,-0.25,-0.25
"3111","55125",21465,6311,53.4,21489,26.2,50.9,5630,-24,681,12.1,-0.23,-0.11,-0.158
"3112","55127",102917,16306,39.4,102310,13.6,37.9,13914,607,2392,17.19,0.02,0.31,0.194
"3113","55129",15638,3826,50.4,15893,21.6,47.6,3433,-255,393,11.45,-0.27,-0.16,-0.204
"3114","55131",133967,21777,42.6,131840,13.6,40.9,17930,2127,3847,21.46,0.23,0.66,0.488
"3115","55133",396731,67480,43.1,389740,14.4,42.2,56123,6991,11357,20.24,1.32,0.56,0.864
"3116","55135",51651,10139,44.9,52377,18,43.4,9428,-726,711,7.54,-0.22,-0.48,-0.376
"3117","55137",24170,5500,48.8,24565,20.2,46.3,4962,-395,538,10.84,-0.25,-0.21,-0.226
"3118","55139",169540,25384,38,166984,13.4,37.8,22376,2556,3008,13.44,0.11,0,0.044
"3119","55141",73427,14068,43.8,74591,17.1,42.5,12755,-1164,1313,10.29,-0.14,-0.26,-0.212
"3120","56001",37944,3911,27.1,36186,8.8,26.8,3184,1758,727,22.83,-0.22,0.77,0.374
"3121","56003",11920,2384,41.2,11636,18,41.8,2094,284,290,13.85,-0.28,0.03,-0.094
"3122","56005",48116,3685,33.2,45840,5.8,31.8,2659,2276,1026,38.59,-0.18,2.06,1.164
"3123","56007",15689,2331,38.2,15781,12.4,39.4,1957,-92,374,19.11,-0.27,0.46,0.168
"3124","56009",14166,2073,40,13779,13.2,40,1819,387,254,13.96,-0.29,0.04,-0.092
"3125","56011",7347,1318,42.2,7036,16.8,44.2,1182,311,136,11.51,-0.31,-0.16,-0.22
"3126","56013",40354,6693,38.3,40103,14.7,38.3,5895,251,798,13.54,-0.21,0.01,-0.078
"3127","56015",13479,2820,43.7,13277,19,42.8,2523,202,297,11.77,-0.28,-0.14,-0.196
"3128","56017",4741,1183,49.7,4791,23.6,49,1131,-50,52,4.6,-0.32,-0.72,-0.56
"3129","56019",8562,1811,45,8564,18.6,44.9,1593,-2,218,13.68,-0.29,0.02,-0.104
"3130","56021",97031,14157,36.8,91719,12.6,37.3,11557,5312,2600,22.5,0.05,0.74,0.464
"3131","56023",18791,2879,39.1,17960,12.5,37.5,2245,831,634,28.24,-0.23,1.21,0.634
"3132","56025",81023,10779,36.3,75876,12.5,36.7,9484,5147,1295,13.65,-0.14,0.02,-0.044
"3133","56027",2479,471,40.4,2478,18,44.5,446,1,25,5.61,-0.32,-0.64,-0.512
"3134","56029",29276,5976,44.2,28203,17.5,43.7,4936,1073,1040,21.07,-0.18,0.63,0.306
"3135","56031",8703,2005,46.7,8677,20.8,47.8,1805,26,200,11.08,-0.3,-0.19,-0.234
"3136","56033",29964,5604,42.1,29097,15.7,42.5,4568,867,1036,22.68,-0.18,0.76,0.384
"3137","56035",10037,1533,37.5,10065,10.3,38.2,1037,-28,496,47.83,-0.25,2.82,1.592
"3138","56037",44527,4339,34,43890,8.3,32.9,3643,637,696,19.11,-0.22,0.46,0.188
"3139","56039",22923,2911,39,21326,9.7,36.6,2069,1597,842,40.7,-0.2,2.23,1.258
"3140","56041",20758,2426,35.1,20942,8.8,34.3,1843,-184,583,31.63,-0.24,1.49,0.798
"3141","56043",8253,1653,43.4,8425,17.7,41.6,1491,-172,162,10.87,-0.3,-0.21,-0.246
"3142","56045",7117,1297,42.2,7152,15.9,41.7,1137,-35,160,14.07,-0.3,0.05,-0.09
